chacun en lui - même est très complexe et le lien entre les deux le est encore davantage de sorte que pour beaucoup la situation présente est confuse .	each of them is very complex , but the link between the two is even more complex which makes the whole situation for most people understandably confusing .
je poursuis la lecture de les recommandations de les commissaires :	the commissionners went on :
ils sont restreints par certaines limites qui ont été fixées pour garantir que la liberté de une personne ne empiète pas sur celle de une autre .	they are constrained by limits which are imposed in order to ensure that the freedom of one person does not violate that of another .
il ne a fait que rendre légal , à toutes fins utiles , le commerce sexuel dans nos rues .	it made the buying and selling of sex on our streets legal for all intents and purposes .
le projet de loi C - 49 , de la façon dont il est présenté aujourd' hui , nous fait sentir que seules les prostituées sont punies et stigmatisées .	the way in which Bill C - 49 has been presented today gives us the feeling that only the prostitutes are punished and stigmatized .
je ne ai jamais rencontré une seule prostituée de rue qui voulait exercer un tel métier .	I never met a street hooker who wanted to be there .
le 28 juin , je ai eu le grand plaisir , avec de autres députés , de voir créer le comité permanent .	the establishment of the standing committee by unanimous consent of the House on June 28 , 1985 has already been noted .
je le ai cité comme exemple de propriété publique créatrice , dynamique et efficace .	I have stressed the CDC as an example of creative , aggressive effective public ownership .
jusque ici , près de $ 250,000 ont été octroyés par le institut en subventions à la recherche ou à de les programmes de éducation de le public .	so far , around $ 250,000 have been issued by the institute in grants for research or public education activity .
permettez - moi de conclure .	let me conclude .
il faudrait examiner sérieusement cette raison pour voir si ce est rentable ou non et si cela sert les intérêts de le public .	I think we should take a hard look at this justification to determine whether or not it is cost effective and in the public interest .
il y a lieu cependant de se interroger sur le avenir en raison de les mesures de austérité annoncées ce printemps dans le budget .	however , that raises some very pertinent questions given the cut - backs announced in the Budget last spring .
le droit de permis passe donc de $ 25 à $ 500 .	we see the licence fee going up from $ 25 to $ 500 .
il aurait été facile de dire que il faut appliquer ces sanctions à le lieu de les rendre facultatives .	it would have been easy to say that these sanctions have to be followed rather than making them voluntary .
nous devons mettre à le point de les programmes efficaces de réadaptation dans nos prisons .	we have to introduce meaningful programs for rehabilitation within our prison system .
Rendons grâce à le ciel de vivre en toute sécurité dans notre pays .	we should count our blessings that we do have a very safe country .
ils ont évidemment mobilisé de les appuis considérables à travers tout le pays .	they , of course , mobilized considerable support across the country .
la famille qui gagne $ 35,000 , lorsque le homme et la femme travaillent tous les deux , cela veut dire quoi ?	what does it mean for a family earning $ 35,000 where the husband and wife both work ?
il est donc essentiel que cette question fasse le objet de un vote aujourd' hui .	I want to make it clear that we have to let this issue come to a vote today .
le premier ministre et le cabinet ne désirent pas dépenser cet argent en Colombie - Britannique .	the Prime Minister and the Cabinet do not want to spend that money in British Columbia .
les enfants ont besoin de jouets et de loisirs .	they need toys and entertainment .
elle ne est assurément de aucune utilité à les moins nantis de notre société .	obviously it does not do one bit of good for the poor people in our society .
je crois que cela donne une bonne idée de les principes à retenir et de ce que devraient être nos responsabilités .	I think that is putting it in a very whole context as to what the principles are and what our responsibilities ought to be .
cependant , il ne a encore rien fait .	however , there is no action forthcoming .
nous aurons fait tellement de concessions que nous serons plus affaiblis que nous devrions le être .	we will have given up so much ground that we will be weaker than we need to be .
avec ce projet de loi , il sera illégal de demander à un chauffeur de taxi comment contacter une prostituée .	under this Bill it would be unlawful for a passenger in a taxi to ask a driver how to contact a prostitute .
si elles ne pouvaient pas payer leurs amendes et que personne ne venait régler leur cautionnement , elles restaient en prison .	if they could not pay their fine and no one would raise bail for them they simply stayed in .
comme vous le savez , monsieur le Président , les lois adoptées dans ces conditions - là sont souvent mauvaises .	as you are well aware , Mr. Speaker , when Governments act under political pressure , they make bad laws at times .
ce projet de loi prétend , je dis bien prétend , faire progresser le égalité de accès à le emploi .	this Bill pretends , and I say pretends , to do something about employment equity .
mais il ne y avait en fait pas de mécanisme de application obligatoire ni de méthode permettant de garantir une véritable participation de les autochtones et de les femmes .	however , there was essentially no enforcement mechanism or method of ensuring that native people and women really became involved in the process .
ils veulent de les résultats .	they want to see results .
le Conseil de le Trésor est chargé de la promotion sociale dans le administration fédérale depuis de les années , mais les femmes ne en ont guère bénéficié .	treasury Board has been responsible for affirmative action in the Government of Canada for some years now and women have little to show for it .
les travailleuses sont encore confinées à les tâches parmi les plus mal rémunérées .	women workers are still confined to most of the job ghettos .
il importe de examiner le équité professionnelle à le sein de les programmes de création de emplois fédéraux .	it is very important that we look at employment equity within the federal job - creation programs .
monsieur le Président , on a vu , hier , une autre fois , que le premier ministre ( M. Mulroney ) a trahi sa promesse .	again yesterday , Mr. Speaker , we saw the Prime Minister ( Mr. Mulroney ) break his word .
que va coûter cette décision , en manque à gagner de recettes fiscales , si elle se applique à de autres sociétés ?	what will be the cost of this particular ruling in terms of lost tax revenue as it is applied to other corporations ?
dès que le revenu de les producteurs devient insuffisant , leurs fournisseurs de matériel et de services commencent à se en ressentir dans la collectivité .	as soon as the growers begin to earn inadequate incomes , those who supply the growers and offer support services in the community begin to suffer .
2 .	2 .
2 .	2 .
oh , oh !	oh , oh !
oh , oh !	oh , oh !
oh , oh !	oh , oh !
souvenons - nous , monsieur le Orateur , que ce sont ces secteurs de notre société qui servent de épine dorsale à notre économie .	let us remember , Mr. Speaker , that these segments of our society form the backbone of our economy .
bravo !	hear , hear !
bravo !	hear , hear !
monsieur le Orateur , ma question se adresse à le ministre chargé de les transports .	Mr. Speaker , my question is directed to the Minister of Transport .
tous deux possèdent de nombreuses années de expérience dans la fabrication et la distribution de les produits forestiers .	both have many years experience in the manufacture and distribution of forest products .
1 .	1 .
je voudrais aussi parler de le droit de le fournisseur de choisir ses clients à son gré .	another point I should like to discuss is the right of the supplier to choose his customers as he sees fit .
je en ai assez de voir que les ministres semblent éprouver certains complexes à le égard de la négociation collective .	i am getting sick and tired of ministers who seem to have some hang - up with regard to the collective bargaining process .
je voudrais commenter un autre point particulier , monsieur le Orateur , avant de me taire .	there is just one specific item more that I would like to comment upon and then I will sit down , Mr. Speaker .
a le ordre .	order , please .
3 .	3 .
il ne y a pas de meilleure autorité en la matière que le député de Don Valley , non pas moi exclusivement .	i can refer him to no better authority on the subject than the hon. member for Don Valley , not just myself .
ce est tout à fait compréhensible .	it is quite understandable .
en outre , elle pourrait constituer une sérieuse menace pour la Confédération et le unité nationale .	in addition , it could become a serious threat to Confederation and national unity .
pour cette raison , nous ne avons pas cru bon de assister à la réunion et en avons informé le COJO en conséquence .	in view of this , we deemed it inadvisable to attend the meeting and so informed COJO .
monsieur le Orateur , le ministre a laissé entendre que un programme de construction plus considérable peut - être une poussée inflationniste .	Mr. Speaker , the minister suggested that a greater building program might lead to inflationary pressure .
je ne partage pas le avis de le ministre .	i disagree with the argument advanced by the minister .
il y a beaucoup à dire sur les deux aspects de cette question .	there is a lot to be said on both sides of that question .
a le ordre .	order .
monsieur le Orateur , comme je le ai signalé à le chef de le opposition , je espère faire une déclaration à ce sujet le1er novembre .	Mr. Speaker , as I indicated to the Leader of the Opposition , I would hope to make an announcement on this question on November 1 .
ce est bien cela .	quite right .
ce ne est pas en isolant quelque un que on le aide à se réadapter .	it does not bring anybody closer to rehabilitation to isolate him from the public .
il laissait une femme et une famille .	he left a wife and family .
monsieur le président je invoque le Règlement ; je suis persuadé que le député de Verdun ne aurait pas déprécié ma position .	on a point of order , Mr. Chairman , I am sure the hon. member for Verdun would not have denigrated my position .
les compagnies de assurance peuvent - elles à leur tour , agir comme compagnies aériennes ?	can the insurance industry in turn act as an airline ?
je vous le déclare , monsieur le Orateur , la population de Toronto sait que le gouvernement est incapable de fournir une réponse .	i say this to you , Mr. Speaker : the people of Toronto know the government has no answers .
on a tout à fait tenu compte de leur avis sur le état de la réserve de poisson .	their evidence on the state of each stock was taken fully into account .
je vous remercie , monsieur le Orateur , et je remercie les députés de me permettre de poursuivre .	thank you very much , Mr. Speaker , and I thank hon. members for allowing me the privilege to continue .
je réclame instamment cette étude approfondie , monsieur le Orateur , car nous ne savons presque rien de les raisons qui transforment les gens en criminels .	i urge this intensive study , Mr. Speaker , for we know so little about the reasons that turn people into criminals .
le gouvernement doit aider ses propres employés qui peuvent avoir besoin de une autre langue pour leur avancement .	the government must assist its own employees who may need another language to advance their careers .
je ne ai pas de scrupule quant à le genre de langage que je tiens .	i do not have any qualms about the type of language I use .
( la motion est adoptée . )	motion agreed to .
monsieur le président , la décision ne est pas prise à ce moment - ci , mais je imagine que ce est oui .	Mr. Speaker , no decision has been reached as yet but I should think so .
la question de les relations commerciales avec nos homologues européens devrait être envisagée très sérieusement .	the matter of trade relations with our European counterparts should be very seriously considered .
ce dont nous , les Canadiens , devons nous soucier , ce est les cas où on exporte ces animaux dans ce but - là .	what we should be concerned with in this country is the situation when these animals are shipped out of Canada for this purpose .
ils ont déjà indiqué les embranchements que ils songeaient à fermer .	they have already given an indication of the branches they intend to close .
ce ministre assurait la garde tandis que la moitié de les recettes et de les bénéfices de le industrie agricole canadienne étaient balayés par le exposé budgétaire .	this minister watched while half the proceeds and profits of the Canadian agriculture industry were swept away in a budget speech .
en aucune façon , monsieur le président .	Mr. Chairman , absolutely none .
nous en faisons actuellement le analyse et je espère que bientôt la Chambre pourra être saisie de les renseignements pertinents .	we are analysing the report now and I hope to have some information for the House in the near future .
bravo !	hear , hear !
bravo !	hear , hear !
je proposerais donc , avec le appui de le député de Halifax - East ( M. Forrestall ) :	i would therefore move , seconded by the hon. member for Dartmouth - Halifax East ( Mr. Forrestall ) :
quand on a saisi le énormité de le ravage exercé par le crime organisé dans notre pays , on doit envisager de les solutions en profondeur .	when we realize the extent of the ravages caused by organized crime in our country , we must consider deep - rooted solutions .
leur popularité a monté en flèche et ils ont traversé la crise avec facilité grâce à cela .	but oh how their popularity soared and they coasted through on that .
( 2 ) Un comité doit se en tenir à le ordre de renvoi et ne saurait y déroger .	( 2 ) A committee is bound by , and not at liberty to depart from , the order of reference .
je voudrais préciser un autre point , et je le fais parce que je estime que il se agit de un débat général .	there is one other point I should like to make , and I do so as I feel this is a general debate .
en décembre , la Colombie - Britannique a fait savoir que elle allait se retirer de le Office canadien de commercialisation de les oeufs .	in December there was an announcement that British Columbia would be withdrawing from CEMA .
bien de les députés de tous les partis de ce côté - ci de la Chambre se y sont également fortement opposés .	they have also given rise to considerable opposition by hon. members in all parties on this side of the House .
ce ne est pas de ces lignes que il faudrait se inquiéter pour le instant .	those are not the lines that one should be concerned about at this time .
le député a pu poser deux questions supplémentaires et , en toute justice , je pense que nous devrions laisser la parole à de autres députés .	i have allowed the hon. member two supplementaries and in fairness I think we should go to some other hon. members .
je crois que ce est une bonne chose .	i think that is good .
je crois que il a pris trop de temps à étudier de les demandes courantes de changements de installations le long de un pipe - line , par exemple .	i think that the time taken in handling routine applications for changes of facilities along a pipeline , for example , has been too long .
le ministre de État chargé de les Sciences et de la Technologie devrait connaître son rayon .	he is the minister who is responsible for science and technology , and he does not know .
les menuisiers de le gouvernement fédéral touchent $ 6.42 à Toronto contre $ 5.23 à Halifax et Moncton .	federal government carpenters get $ 6.42 in Toronto and $ 5.23 in Halifax and Moncton .
je aimerais mentionner à ce sujet un communiqué de presse qui a suivi la conférence fédérale - provinciale de les procureurs généraux de octobre 1975 .	for the record I would like to refer to a press release which followed the federal - provincial conference of attorneys general in October , 1975 .
monsieur le Orateur , je invoque le Règlement .	Mr. Speaker , I rise on a point of order .
je pense que le terme ferroviaire est « chargement sur demande » .	i think the railroad term is « demand loading » .
je reviendrai plus tard à ce que coûte un bâtiment de pêche de nos jours .	i will come to the cost of boats these days .
dans la plupart de les provinces , de les règlements généraux sur le bruit ont été mis en application , et dont le principe général se énonce ainsi :	in most provinces , general noise regulations have been implemented , the main principle of which is as follows :
de accord .	agreed .
après tout , le énergie est un bien collectif et le gouvernement pourrait fort bien adopter une politique de encouragement comme celle dont je ai parlé .	after all , energy is used by people throughout the nation , and the government might well consider an approach using the incentive to which I have referred .
6 .	6 .
je serai heureux , quand nous en aurons le temps , de me asseoir avec les député et de explorer la question de façon productive .	i will be glad , when we have time , to sit down with hon. members and work this matter out on a productive and prospective basis .
le ministre prendra il de les mesures pour résoudre les difficultés , car il est absolument nécessaire de passer les commandes maintenant et non dans quelques mois ?	will the minister take action to clear up any difficulties because of the absolute need for placing the orders now , and not some months from now ?
cela encouragera la construction de nouvelles embarcations de pêche et la création de nouvelles conserveries .	it will spur the construction of new fishing boats and cause new processing facilities to be built .
il y a bien de les choses que je pourrais dire à propos de le bill C - 19 .	there are many things I could say about Bill C - 19 .
je reviendrai sur cet aspect un peu plus tard , car je pense que ce est un élément que il est essentiel de souligner cet après - midi .	i am going to say something a bit later on about that because I think it is essential to the kind of debate we are having this afternoon .
les sociétés trouvent que les règlements sont compliqués , lourds et que on les modifie sans cesse .	companies find that the rules are complicated , cumbersome and changing all the time .
monsieur le Orateur , ma question se adresse à le ministre chargé de la Commission canadienne de le blé .	Mr. Speaker , my question is for the minister in charge of the Canadian Wheat Board .
si je comprends bien , on prévoit un taux de intérêts annuel de 70 % .	i understand that a rate of at least 70 per cent per annum is being contemplated .
nous souhaitons parvenir à une décision cette semaine .	it is our hope to make a decision this week .
nous acceptons votre opinion .	we accept your view .
il fit campagne là - dessus pendant les élections .	they fought an election on that position .
12 .	12 .
monsieur le Orateur , voici ce que je ai à en dire : quelle cruelle comédie , car ce est jouer la comédie .	Mr. Speaker , I say to that : what a cruel hoax , because a hoax it is .
monsieur le Orateur , nous essaierons de nous en tenir à cette suggestion .	Mr. Speaker , we will try to stick to that suggestion .
1 . a ) $ 98,355 . b ) Ils sont disponibles dans tous les grands bureaux de poste de le pays .	1 . ( a ) $ 98,355 . ( b ) They are distributed through major post offices across the country .
en vertu de la constitution , le activité criminelle est de compétence fédérale , tandis que le application de la loi relève de les provinces et de les municipalités .	crime is a national problem according to our constitution , while law enforcement is a provincial and local responsibility .
je prétends que mes remarques concernant le bill , le argent dépensé pour les soins médicaux et la façon dont on le dépense .	i submit that what I say is pertinent to the bill , to moneys being spent on medicare and the manner in which they are spent .
de abord quelques mots à le sujet de cette maladie pour vous situer .	a few words about this disease might help to put things into perspective .
heureusement , il y en a moins cette année , elles sont plus raisonnables , plus sérieuses et plus conciliantes .	fortunately they are fewer this year , more reasonable and responsible , more conciliatory .
ce projet de loi est à le étude à la Chambre depuis plus de un an .	this bill has been before the House for more than a year .
cette personne a pris sa retraite le 30 décembre 1975 après avoir complété 34 années à le service de le public .	retired December 30 , 1975 following completion of 34 years of public service .
le adoption de la motion de le député signifierait que la loi préciserait en détail les exigences de contenu et que nous pourrions les discuter .	passage of the hon. member 's motion would mean that the content requirements are spelled out in the statute and we could debate them .
cela ne veut pas dire nécessairement que il y a défaut de se y conformer de la part de les parties .	this does not necessarily indicate non - compliance on the part of the parties .
je ne lui ai pas demandé de me fournir de telles explications sur ces activités .	i was not asking for a detailed explanation as to what he was doing .
comment peut - on tant demander de une part et être assuré de si peu de le autre ?	how can so much be asked , on the one hand , and so little answered on the other ?
peut - être proposera il ensuite une mesure nouvelle et différente qui ne le exposera pas à les accusations de censure .	as a result , perhaps he will bring in different legislation which will not lay him open to the charge of censorship .
ou ils font leur travail convenablement , ou ce est à vous de obtenir le pouvoir nécessaire pour les amener à le faire .	either they do their job properly , or you must get the power so that you can be sure that they do it properly .
on y retrouve en effet toutes les tensions et toutes les divergences de notre pays .	in our national capital we have all the strains and all the divergencies of our country .
le hon. John N . Turner ( ministre de les Finances ) propose :	hon. John N . Turner ( Minister of Finance ) moved :
bien que il me coûte de le admettre , les gouvernements libéraux à le Canada ont présenté de bonnes mesures législatives ...	as much as I hate to admit it , there has been good legislation brought in by Liberal governments in this country --
en tant que député de une circonscription voisine , je connais fort bien sa persévérance et son acharnement à le travail .	as the member for the neighbouring riding I am well aware of his persistence and hard work .
où est la CAI ?	where is the AIB ?
malheureusement , à le heure actuelle , cette réalité est perçue par les deux tiers de la population non pas comme un avantage , mais comme un obstacle .	at the moment , that fact , unfortunately , is seen in two - thirds of the country not as an opportunity , but as a barrier to opportunity .
ne nous forcez pas à accepter un moratoire .	do not force a moratorium down our throats .
ce ne est pas la première fois que les députés en entendront parler .	this not the first time that members of parliament are going to hear that .
on trouvait la même recommandation dans le rapport de le 29 avril de le an dernier de le comité permanent de les privilèges et élections .	the same recommendation was made in the report of the Standing Committee on Privileges and Elections on April 29 of last year .
je crois , monsieur le président , que le ministre est mal informé .	Mr. Speaker , I am afraid the hon. member is ill informed .
dans le rapport de le ministère de les Transports sur le accident , il est dit :	in the MOT accident report it is stated :
monsieur le Orateur , le gouvernement fédéral a offert un programme de 100 millions de dollars .	Mr. Speaker , the federal offer was for a $ 100 million program .
dans la plupart de les échantillons de cette importance , ce est - à - dire un groupe de plus de 500 personnes , cela serait considéré comme négligeable .	in most samples of this size -- that is , a group of over 500 -- this would be called negligible .
de ordinaire pour demander de nouveaux pouvoirs de emprunt ou annexer un article à les bills de finances provisoires présentés à la Chambre .	the traditional procedure for seeking new borrowing powers is to attach a clause to supply bills brought before the House .
cela touche à le coeur même de notre démocratie puisque il se agit de le droit de le peuple à le information .	this strikes at the roots of democracy , and it is the right of the people to know .
cela réduirait la demande de pétrole .	this would relieve the pressure on oil .
la Division de les enquêtes spéciales a été abolie à le début de 1975 .	the Special Investigation Division has not been in existence since early 1975 .
de plus , il ne se agit pas de faire savoir si le on est pour ou contre une forme de aide à les parents adoptifs .	moreover , this is not a matter of saying whether we are for or against some sort of assistance for adoptive parents .
montrez - nous les documents .	let us see the documents .
le Canada continue à accorder son soutien à le alliance de le OTAN comme force de dissuasion et comme assurance absolument indispensables à notre sécurité .	canada has continued to give its support to the NATO alliance as an absolutely indispensable deterrent and an absolutely indispensable assurance of our security .
pouvez - vous imaginer une telle mesure en 1978 ?	can you believe such a ban in 1978 ?
non , monsieur le président .	no , Mr. Chairman .
bien entendu , le gouvernement tente de conclure le meilleur marché possible pour les Canadiens en faisant une série de négociations .	naturally , the government attempts to get the best possible deal for the Canadian public in any series of negotiations .
je ajouterais , monsieur le Orateur , que il faut la maintenir à ce niveau .	i would add , Mr. Speaker , that it must be continued .
si je veux obtenir de les chiffres sur la situation de le Canada , je ne irai certainement pas consulter le discours prononcé par le premier ministre .	if I want any statistics as to where this country stands , certainly I will not refer to the speech made by the Prime Minister .
nous avons étudié tous les aspects de la question .	we looked at all the implications of that .
mieux vaut sans doute que je cite un journaliste de Timmins qui songeait vraisemblablement à le député .	perhaps it would be a good idea for me to quote a Timmins newspaper because maybe it relates to the hon. member .
monsieur le Orateur , il est vrai que je ai reçu le rapport de le comité de action de les chemins de fer de les Prairies .	Mr. Speaker , indeed I have the final report from the Prairie Rail Action Committee .
( ii ) a ) 3 véhicules seront utilisés par 6 spécialistes canadiens dans le cadre de la prestation de aide technique .	( ii ) ( a ) Three vehicles will be used by six Canadian experts related to the provision of technical assistance .
1979 .	1979 .
et nous allons appliquer chacune de les recommandations contenues dans le rapport de le Vérificateur général , chose que nous réclamons depuis dix ans .	and we will implement every recommendation in the Auditor General 's report , something which we have been calling for over the last ten years .
je voudrais commencer , monsieur le Orateur , en faisant quelques observations générales .	first , Mr. Speaker , I should like to make a few general remarks .
monsieur le Orateur , je vais voir si ces chiffres sont disponibles , mais je déplore les expressions que le député a utilisées .	Mr. Chairman , I will see if there is such a figure available , but I would quarrel with the words of the hon. member .
je sais que il ne a pas le intention de me empêcher de répondre à la question fort sérieuse que me a posée son collègue .	i know he would not want to divert me from responding to a very serious question by his colleague .
le opposition nous chante toujours la même rengaine : ce programme coûtera de le argent à le gouvernement .	continually we get the message from across the way that this program will cost the government something .
notre taxe de 18 cents ne leur plaisait pas .	that is the crowd which did not like the 18 cents .
le problème est de savoir si la population canadienne a le droit de être informée sur sa constitution .	what is at issue here is the principle that the public of Canada has a right to know about the constitution of Canada .
ils veulent choisir eux - mêmes qui ils vont défendre .	they want to pick and choose what they will support .
est - ce que cela a été mis par écrit ?	do you have it in writing ?
je suis conscient , monsieur le président , que il ne existe pas de solution miracle .	i realize , Mr. Chairman , that there is no magic solution .
en 1978 , on a enregistré 1,122,000 divorces sur le continent .	in 1978 Americans divorced 1,122,000 times .
le chômage brise les familles et porte à le alcool et à la drogue .	the very result of unemployment breaks up families , and contributes to excessive alcohol and drug use .
le opposition officielle a essayé de détruire Petro - Canada pendant son bref règne de six mois .	the official opposition was trying to destroy Petro - Canada in the short six months it was in office .
et que à le lieu de provoquer la rupture ,	instead of causing an internal schism ,
ils se sont prononcés contre une mesure qui aurait garanti à les Canadiens de les approvisionnements sûrs .	and now they are applauding themselves for voting against security of supply .
a propos de contribution , cela me rappelle une histoire .	as to making contributions , I am reminded of a story .
madame le Président , je aimerais entendre ce que va dire le député avant de proposer ma motion .	madam Speaker , I would like to hear from the hon. member before I move my motion .
le orateur qui me a précédé a dit également que il aimerait voir les provinces participer à les préparatifs de les réunions .	the previous speaker also mentioned they would like to have the provinces involved in preparations for any meetings .
mon collègue de Toronto dit encore 53 ans .	my friend from Toronto says 53 more years .
de après toutes ces estimations , le Canada sera en bien plus mauvaise posture par suite de le programme que il ne le était auparavant .	all of those estimates indicate that Canada will be in much more trouble as a result of the National Energy Program than we were in before .
monsieur le premier ministre ,	Mr. Prime Minister :
en fait , elle aura de les effets plus destructifs que positifs .	indeed , there will be more divisiveness than positive effects .
le inflation mondiale crée de graves tensions économiques .	world - wide inflation is causing a severe form of economic dislocation .
le PT7 représente le début de une nouvelle famille de moteurs dans un niveau de puissance au - dessus de le moteur PT6 qui est hautement couronné de succès .	the PT7 represents the beginning of a new family of engines in a power range above that of the highly successful PT6 engine .
monsieur le Orateur , je suis heureux de avoir le occasion de participer à ce débat de ajournement ...	Mr. Speaker , I welcome the opportunity to join in this adjournment debate --
cette politique joue un rôle aussi important dans une stratégie industrielle que le plan de ensemble ou que les plans détaillés que il faut mettre à le point .	the competition policy is as vital to an industrial strategy as the over - all plan or the specific set of plans which should be developed .
on dit maintenant que la construction de le gazoduc va coûter environ 45 milliards de dollars .	we are now talking about $ 45 billion to construct the pipeline .
signalons par ailleurs que on trouve toutes ces lacunes dans le bill .	these flaws are all reflected in this bill .
a ce stade de le débat sur la résolution , mon parti propose trois amendements précis .	at this stage of the debate of the resolution , there are three specific amendments which my party proposes to introduce .
il ne peut donc pas prétendre avoir apporté le moindre changement à le niveau de le ensemble .	the government cannot claim that there is any change in the balance of ways and means .
ce est dans le cadre de ce programme et de ententes auxiliaires que le gouvernement accorde la majeure partie de son aide à le expansion régionale .	a substantial provision of federal assistance for regional development comes under this program , RIDA , and subsidiary units .
que a fait le gouvernement à ce sujet ?	what did the government do ?
si nous utilisons le chômage pour combattre le inflation , nous pourrons relancer le économie , voilà la position de le gouvernement .	he said that if we use unemployment as the solution to inflation , we will get recovery .
la conservation commence à produire de le effet .	conservation is beginning to have its effect .
on pourrait implanter une aciérie en Colombie - Britannique , par exemple .	there could be a steel mill in British Columbia , for example .
a le ordre !	order , please .
voilà pourquoi les professions libérales ne devaient pas être imposées pour les travaux en cours .	that is why professionals should not be charged for their work in progress .
monsieur le Président , je crois que ce qui se passe aujourd' hui est intéressant , mais ce ne est que un début .	i believe , Mr. Speaker , that what is happening today is a good thing but it is just the beginning .
cependant , ce sont les contribuables qui sont obligés de payer .	however , the people of Canada are responsible for making those payments .
le projet de loi a pour but de revenir sur de les programmes qui ont été mis en place à une époque où nous pouvions nous le permettre .	we are now faced with legislation that is designed to withdraw from programs that were introduced at a time when we could afford them .
ce est pourquoi nous avons dû importer 25,000 travailleurs spécialisés à un moment où le chômage augmentait .	that is why we had to import 25,000 skilled workers into this country at a time when unemployment was rising .
comme Carter le a si bien dit dans les années 60 , une piastre est toujours une piastre , et il faut le imposer comme tel .	as Carter said back in the 1960s , « A buck is a buck is a buck » and should be taxed as such .
a le ordre , je vous prie .	order , please .
cela donne en tout une réduction de $ 2,958 à le cours de les deux prochaines années , soit 15 % de le salaire initial de $ 20,000 .	all of this means a total cut over the next two years of $ 2,958 , or 15 per cent of the original $ 20,000 salary .
de après les nouvelles de ce matin , la mine de minerai de fer à Heath , dans le nord de le Nouveau - Brunswick va fermer .	we heard in the news this morning that the Heath - Steele mine in northern New Brunswick is being closed down .
ils sont prêts à suivre cet exemple .	they are ready to follow our leadership .
a le heure actuelle , un certain nombre de programmes de ce genre fonctionnent déjà et nous prévoyons en lancer de autres .	we have a number of those kinds of programs and discussions going on at the present moment .
nous devons nous demander comment il se fait que cette abondance de idées et de activité ne ait pas résolu le problème de le développement .	out of that momentum of ideas and activity , we have to ask ourselves , why has the development problem not been solved ?
je voudrais terminer sur une note positive , monsieur le Orateur .	i would like to end on a positive note , Mr. Speaker .
je voudrais que il soit bien clair , monsieur le Orateur , que le gouvernement fédéral ne fixe pas les prix de détail .	i want to make it plain , Mr. Speaker , that the federal government does not set retail prices .
la séance est ouverte à 2 heures .	the House met at 2 p.m.
je rappelle , monsieur le président , que le ministre parlait , pour les lignes de transmission de électricité , de les mêmes pouvoirs qui existent déjà .	i remind hon. members that the minister in respect of transmission lines referred to the same power that now exist .
ce est vraiment un objectif souhaitable que nous visons tous .	that is truly a laudable goal with which we all agree .
madame le Président , je voudrais poser une question supplémentaire à le ministre de les Transports .	madam Speaker , I have a supplementary question for the Minister of Transport .
prenons maintenant Petro - Canada .	let me come now to Petro - Canada .
cela va apporter de les économies énormes .	this will result in tremendous savings .
malheureusement , personne ne semble savoir quels seront à le juste ces effets .	unfortunately , no one seems to know what the effect will be .
nous avons permis à un sous - gouvernement de arracher de les pouvoirs à la Chambre de les communes .	we have allowed a subgovernment across the country to remove power from the House of Commons .
ce est une somme considérable .	that is quite substantial .
que se passe il exactement ?	what exactly is going on over there ?
madame le Président , je serai très bref .	madam Speaker , I will be very brief .
le gouvernement dit tout simplement à les gens ce qui est bon pour eux .	that Government simply tells the people what is good for them .
ce sont les données désaisonnalisés , celles qui montrent une baisse de 5 % , qui comptent .	it is the seasonally adjusted figures which show the .5 per cent drop which are the important figures .
les discussions qui se déroulent en ce moment mettent la présidence dans une situation fort embarrassante .	the Chair is really embarrassed by what is taking place .
monsieur le Président , je regrette , mais je ne ai pas vu ce communiqué de la société britannique .	Mr. Speaker , I am sorry , I have not seen the statement by a British firm .
il y a moins de bénévoles , car beaucoup de femmes sont retournées sur le marché de le travail .	fewer volunteers are available because so many women have returned to the work force .
elles travaillent avec eux .	they work with them .
leur succès dépend de la mesure dans laquelle ils se appliquent .	it depends on the extent to which they apply themselves .
je ne sais pas se il existe un seul député à la Chambre qui se opposerait à ce que on donne davantage de argent à les personnes âgées .	i do not know if there is a Member in this House who would oppose allocating more money for the elderly .
eux aussi ont un rôle à jouer dans la chaîne alimentaire .	they also have a role to play in the food chain .
un aspect plus démocratique a été ajouté à les situations qui se présentaient dans nos circonscriptions .	this has given a more democratic element to the things we were faced with in our constituency .
il faudrait plutôt se efforcer de faire oublier les propos stupides que a tenus le ministre la semaine dernière .	the problem is to obscure the memories of everyone who heard the Minister 's stupid statements of a week ago .
le ministère remplira il le ravin qui se trouve à le extrémité de la piste 24L à le aéroport international Pearson de Toronto ?	will the Ministry fill in the ravine at the end of runway 24L at the Pearson International Airport at Toronto ?
si nous décidons de présenter un tel projet de loi , je lui rappellerai son offre .	if we ever introduce such legislation , I will remind him of his offer .
a cela , je réponds :	my response is , so what ?
ce est ce que je recommande à la Chambre de faire , monsieur .	this , Sir , is what I recommend to the House .
je ignore si cela servira à quelque chose .	whether that will do any good , I do not know .
voilà le principe dont le Alliance doit se inspirer en cherchant à conclure de les accords justes et vérifiables avec le Union soviétique .	that is the principle which must guide the Alliance in the future as we seek fair and verifiable agreements with the Soviet Union .
la même réponse se applique à les automobiles .	i guess the same kind of answer would have to apply to the matter of automobiles .
il a saisi la Chambre de un projet de loi qui aura pour effet de les restreindre .	they are bringing before the House a Bill that will restrict those liberties .
le député de Bow River ( M. Taylor ) intervient dans le débat .	for debate , the Hon. Member for Bow River ( Mr. Taylor ) .
monsieur le Président , je invoque le Règlement .	Mr. Speaker , I rise on a point of order .
le gouvernement ne veut pas le croire .	the Government refuses to believe it .
ce étaient là de les engagements extrêmement intéressants et assez révélateurs sur ce que pourrait devenir ce secteur fondamentalement important , le agriculture .	those were very challenging commitments , a sort of preview of what the very important agricultural sector might become .
il se agit de le syndrome de la porte tambour et la réarrestation immédiate .	there are two revolving - door syndrome and gating .
je espère que ensuite il portera le flambeau .	i hope he will be back with that mobilized public opinion .
le argument de le gouvernement est erroné , à mon avis .	i think the argument being made by the Government is faulty .
toutefois , nous avons suffisamment de argent pour renflouer deux banques .	however , we do have enough money to bail out two banks .
le Règlement !	order .
ces créations peuvent être volées comme ne importe quel autre type de propriété .	it can be stolen just as other types of property can be stolen .
deuxièmement , monsieur le Président , ce que nous avons fait depuis novembre dernier , ce est une amélioration de le climat de confiance .	and , second , Mr. Speaker , what we have been doing since last November is building up a climate of confidence .
ce sont de les établissements financiers très importants dans le ouest de le Canada .	members should know that credit unions are a very big factor in financial institutions in western Canada .
le député de Cochrane - Supérieur ( M. Penner ) a dit tout à le heure que ce était à le gouvernement de libérer ses députés .	the Member for Cochrane - Superior ( Mr. Penner ) said earlier tonight that the onus is on the Government to free up its Members .
ce est vrai .	that is my point .
que fait - on de les femmes qui vivent loin de les centres où ces services sont offerts ?	what of women who live far from centres where these services are available ?
ils demandent à les députés de le Parlement de mettre fin à toute réduction de personnel dans ces ateliers .	they ask the Members of this House to put an end to all cuts in personnel at these shops .
ce ne est pas une question de me joindre à le député ; nous avons de le avance sur lui .	it is not a question of joining ; we are well ahead .
le Dr Kenneth Hare , considéré chez nous comme le un de nos spécialistes les plus éminents de les questions atmosphériques , a écrit un article où il précise :	in an article written by Dr. Kenneth Hare , recognized in this country as being one of our foremost atmospheric scientists , the following appears :
cela aura de les répercussions un peu partout .	the impact is pervasive .
en de autres mots , les céréaliers américains toucheront une subvention de environ $ 2 le boisseau que leur versera le gouvernement de M. Reagan .	in other words , a subsidy of about $ 2 per bushel will come from the Reagan administration to the grain farmers of the United States .
le rapport complet sera déposé de ici le automne prochain .	the full report will be coming in before the fall .
si ces règles étaient appliquées , est - ce que nous traiterions effectivement tout le monde sur le même pied ?	if these rules were put in place , would we indeed be treating everyone in the same way ?
cette éminente autorité à la Chambre de les communes a parlé de harcèlements sexuels , de certaines femmes qui avaient été obligées de se dévêtir pour obtenir un emploi .	in them this former distinguished Speaker of the House talked about sexual harassment where some women had to disrobe to qualify for their jobs .
je ne fais que avertir les députés de le existence de un problème à cause de ce qui se est passé .	i am simply alerting Members to a problem that I see , given what has been happening .
Évidemment , quand les conservateurs étaient dans le opposition , ils tenaient de les discours qui étaient à le opposé de leurs actions de aujourd' hui .	the Conservatives while in Opposition , of course , said quite the contrary to what they are doing now .
en réalité , le ministre de la Justice et le solliciteur général ont répondu avec tous les détails que ils pouvaient humainement donner .	in point of fact , both the Minister of Justice and the Solicitor General have responded fully , as best human beings can .
le vice - premier ministre croit - il que ce est ainsi que un gouvernement conscient de ses responsabilités , ou un pays indépendant doit conclure un traité international ?	does the Deputy Prime Minister believe that this is the way for a responsible Government , or an independent nation , to make an international treaty ?
le sous - comité parlementaire est en train de examiner toute la question de les droits à le égalité .	the parliamentary subcommittee is considering the whole question of equality rights .
en réalité , pour les demandes concernant moins de quatre étudiants , on ne essaie pas de savoir si les emplois sont axés sur la carrière ou non .	the fact is that no applications involving fewer than four student employees is being subjected to any test of whether or not the jobs are career oriented .
de plus , nous voulons une série de critères objectifs fondés sur les éléments que je mentionne ici , par exemple :	we also want a series of objective criteria based on factors such as those I am referring to .
si nous adoptons pareille attitude pour cette question ou de autres de le domaine public , nous trouverons toujours de les excuses pour éviter de passer à le action .	if we proceed on that basis in this or in any other direction in public life , we will always be able to find excuses .
vous avez alors instauré votre programme , le hôtel a été abandonné et Fort St. John est devenu une ville fantôme .	then you brought in your program , the hotel went down the tube and Fort St. John became a ghost town .
nous , en six mois , on a consulté , on se est assis avec le ministre et on est arrivé à une entente .	well , in six months , we did consult , we sat down with the Minister and hammered out an agreement .
le très honorable député ne est peut - être pas non plus de accord avec le point de vue de Mme Bégin .	the Right Hon. Member might disagree with her perspective as well .
" essayons - le , disent - ils , et voyons ses effets .	" let us try it , " they say , " and see if it works .
le MEER fournit environ 3 millions de ce montant et le ministère de les Affaires indiennes et de le Nord le reste .	approximately $ 3 million of this amount is allocated from DREE funds , with the remainder being committed by the Department of Indian Affairs and Northern Development .
on ne répétera jamais trop que les Canadiens se inquiètent de la montée de la grande criminalité .	it cannot be stressed too often that Canadians are disturbed by the increase in violent crime .
les exportations de grains doivent fléchir de 25 % pendant la campagne 1984 - 1985 .	grain exports are projected to fall by 25 per cent in the 1984 - 85 crop year .
notre retard dans ce domaine est si important que tous les Canadiens en sont gênés .	we are so far behind in this field it makes the whole country feel embarassed .
on ne modifie pas vraiment la situation .	they do not really change the status .
il est désormais impossible de établir une distinction valable quelconque entre les missiles nucléaires de portée intermédiaire et de portée intercontinentale .	there is no longer any distinction to be made on a rational basis between an intermediate range and an intercontinental range nuclear missile .
puis - je demander à le député de Western Arctic de être bref , si possible .	could I ask the Member for Western Arctic for a brief answer , if possible .
le Grand Victoria est considéré comme la Mecque de le tourisme à le Canada .	greater Victoria is a tourist mecca .
la taxe ne serait pas prélevée pour être remboursée par la suite .	that tax will not be collected and then refunded .
on se est déjà engagé à faire en sorte que leur taux de participation se accroisse de manière à atteindre à le moins les niveaux historiques sinon traditionnels .	there has been a commitment in the past that their participation rate would go at least to historic levels if not traditional levels .
ce est - à - dire à la demande de la personne qui va peut - être prétendre à le statut de réfugié .	that is to say , at the request of the person who may be going to declare his refugee claim .
voilà où nous en sommes actuellement .	that is the actual situation .
les paiements de péréquation ont acquis à le cours de les ans une ampleur considérable .	equalization payments have become quite considerable through the years .
les représentants de tous les partis se inquiètent de cette question .	it has been a matter of concern to representatives of all parties .
je tiens également à signaler que nous avons consulté le caucus progressiste conservateur de le Manitoba et un certain nombre de personnes de cette province .	i would also like to advise the House that there was a degree of consultation with respect to the PC caucus members from Manitoba .
la localité gardera un bon souvenir de le personnel militaire et de leur famille qui ont participé à la vie de cette localité .	the part played by military personnel and their families in the life of the town will be long remembered in a most favourable light .
en toute déférence , je dois interrompre le très honorable premier ministre .	with great respect , I must interrupt .
alors , je le ai expliqué .	i explained it then .
si le premier ministre a déclaré que il est prêt à négocier encore avec le Québec , pourquoi adopter en vapeur ce projet de loi ?	if the Prime Minister said that he was willing to resume negociations with Quebec , why are they in such a hurry to pass this Bill ?
ce est la raison de ailleurs pour laquelle certains de mes collègues ont fait de les interventions relativement rigoureuses à ce sujet .	in fact , that is why a number of my colleagues have spoken out quite vigorously on the subject .
je tiens à exposer la teneur précise de les notes qui figurent dans le état financier de le 31 mars 1984 .	i should like to put on the record just exactly what is in the notes on the financial statement of March 31 , 1984 .
cette décision est alors envoyée à le particulier en question .	that judgment is sent to the individual in question .
tout cela est insensé .	that does not make sense .
dans ce dossier , monsieur le Président , de nombreuses autorités se sont donné la main pour réagir immédiatement à la situation de urgence .	Mr. Speaker , many authorities were involved in acting on this emergency .
que est - il donc advenu de les études qui ont été effectuées après cet incident ?	however , what happened to the studies that were conducted after that incident occurred ?
le ex - ministre de les Transports avait clairement établi que ces règlements ne seraient promulgués que dans un an .	there was a clear understanding by the former Minister of Transport that these regulations would not be promulgated for a year .
je estime que nous ne avons pas les moyens de nous payer plus longtemps une pareille façon de se comporter à le cabinet .	i feel that is an attitude in Cabinet which we do not have the luxury of allowing to continue .
ce est donc dire , monsieur le Président , que le gouvernement se doit de respecter les recommandations de le Commissaire à les langues officielles .	in other words , Mr. Speaker , the Government must implement the recommendations of the Commissioner of Official Languages .
ensuite , ils réduiront le nombre de les emplois car les entreprises que ils auront achetées feront double emploi avec de autres que ils ont déjà .	they will then reduce the number of jobs because what they buy will be a duplication of other operations they have .
ce est à la deuxième étape de réexamen que la Cour suprême a établi que une audience est obligatoire .	it is at the second stage of review that the Supreme Court has ruled that a hearing is compulsory .
en ce qui concerne les avocats spécialisés en immigration , le barreau se charge de les pénaliser .	as for lawyers specialized in immigration matters , the Bar takes upon itself to penalize them .
le autre solution consiste à investir sous forme de prêts .	the alternative in terms of foreign investment is loan capital .
veut - il attendre que le économie de ces régions agricoles soit complètement à terre avant de réagir à le problème de les pluies acides ?	does he want to wait until the economy of those rural areas is completely down before responding to the acid rain problem ?
il me semble que cela ne est pas compliqué à comprendre .	i think that should not be too difficult to understand .
nous ne devons pas oublier toutefois que la majorité de les producteurs de boeuf et de porc ont carrément rejeté tout mécanisme de régularisation de les mises en marché .	however , we must not forget that the majority of beef and pork producers have rejected outright any mechanisms for marketing stabilization .
si je avais été à la place de Bryce , je aurais partagé le assiette à le beurre avec les autres .	if I had been in Bryce 's position , I would have been right in there with my nose to the public trough with the rest of them .
en un mot , nous considérons que le rôle politique et le rôle administratif doivent être séparés le un de le autre .	in other words , we consider that the political role and the administrative role should be kept separate .
on le a négligé et liquidé , ce qui a obligé le gouvernement à investir pour faire absorber cet atelier .	as a result , the Government had to take steps to see that the company was taken over .
tous ces endroits inclus dans notre patrimoine sont gérés par Parcs Canada à le profit et pour le agrément de tous les Canadiens .	all of these heritage places are managed by Parks Canada for the benefit and enjoyment of all Canadians .
comme je le ai dit tout à le heure , pareilles distinctions ne avaient pas été envisagées lorsque le projet de loi a été adopté en deuxième lecture .	as I indicated earlier in this ruling , such discrimination was not envisaged in the Bill when it was given second reading .
les secteurs public et privé ont tous deux un rôle à remplir .	there is a role for both the public and the private sector .
les critiques seront de autant plus vives que le gouvernement actuel , sauf erreur , se est engagé à agir à le grand jour .	there will be more criticism , perhaps , because this Government , as I understand it , is committed to making things more open to the public .
ce ne est pas suffisant .	that is not good enough .
ce est lui qui nous a dit que la construction de le centre de entretien de VIA Rail à Montréal était remise à les calendes grecques .	he was the one who told us that the construction of a maintenance centre for VIA Rail in Montreal would be indefinitely postponed .
cependant , M. Baldwin avait ensuite déclaré :	but then Mr. Baldwin said :
nous voulons que les promesses faites par les sociétés qui reprennent de les entreprises canadiennes soient révélées publiquement .	we want full public disclosure of company commitments involved in take - overs of Canadian business .
il faut également consulter les gouvernements provinciaux pour définir les besoins de certaines régions .	there is also a need to co - ordinate with provincial Governments as to what certain areas require .
ils pensent que en changeant simplement le nom de AEIE en Investissement Canada , nous aurons un afflux de dollars .	they are of the opinion that by just changing the name from FIRA to Investment Canada we are going to have an automatic inflow of dollars .
est - ce que le ministre peut donner en cette Chambre la position de le gouvernement canadien ?	can the Minister tell this House what position the Canadian Government will take in this regard ?
voici maintenant neuf mois que le nouveau gouvernement a été porté à le pouvoir , et nous attendons toujours son premier budget .	it is nine months since the election of this Government and we have yet to see a Budget .
nous acceptons à le heure actuelle que soient enregistrées les associations canadiennes de sport amateur et il faudrait en faire autant pour les groupes provinciaux .	we currently allow the Canadian amateur athletic associations to be registered , and it is my belief that we should allow the provincial groups as well to be registered .
par définition , « association canadienne de sport amateur » se applique à les associations fédérales , mais non à leurs contreparties provinciales .	a Canadian amateur athletic association by definition includes federal associations but does not include their provincial counterparts .
cette bataille a ravi à le Canada 1,800 vaillants marins et 24 fiers bâtiments .	to this battle Canada gave 1,800 gallant sailors and 24 proud ships .
je trouve incroyable que le président de le Conseil de le Trésor se permette de rire de un sujet aussi grave .	i find it incredible that the President of the Treasury Board would be laughing about a matter as serious as this .
de plus , ils ont demandé de les budgets supplémentaires .	they have also asked for additional funding .
bon , tout le monde est de accord là - dessus .	well , everyone would agree with that .
le poste de directeur général a été vacant durant plus de un an , et pour cause .	it is no wonder that there was no permanent chief executive officer for over 12 months .
le ministre a parlé de réunions , fort bien .	the Minister spoke of meetings and I applaud that .
il fallait que il soit à Saint - Jean .	we had to put that in St. John 's .
ce est exactement ce qui se passe .	that is an accurate description of what is happening .
il ne est pas question de les traiter séparément .	they cannot be treated in isolation .
de toute évidence , il ne aime pas les gens qui appartiennent à le mouvement coopératif dans le est de le Canada .	he obviously does not like the co - op people in eastern Canada .
il incombe à le gouvernement fédéral de jouer le rôle de agent de surveillance .	the federal Government has a responsibility to be a policing agent .
la Société veut que les employés à temps partiel constituent dorénavant 45 % de tous ses effectifs .	it wants to increase the percentage of its part - time workers to 45 per cent of its total work force .
À le cours de les dernières élections provinciales à le Manitoba , 900 personnes ont voté par la poste ; surtout de les citadins .	in the last Manitoba provincial election , 900 mail - in votes were received and were mostly from urban voters .
alors le gros bon sens ce est quoi ?	what does basic common sense say ?
les abattoirs bâtis selon la réglementation québécoise ont de les normes plus sévères .	standards are actually stricter in abattoirs built according to Quebec regulations .
les techniciens gagnent plus de argent que les écrivains et les auteurs de pièces de théâtre .	technicians make more than the writers and playwrights whose works are being performed .
ils étaient tous gauchistes .	they were all leftists .
elles sont bien faites .	it is well done .
certes , nous demeurons un petit pays et nous sommes vulnérables pour cette raison .	yes , we are a small nation and we are vulnerable because of our size .
m. Wyman compte de nombreuses années de expérience dans le secteur de les marchés financiers .	Mr. Wyman has many years of experience in the financial market sector .
réfléchissons - y un petit instant .	let 's think about that for just a moment .
il est inutile , je crois , de continuer à tourner autour de le pot pour régler la question .	i do not think we should beat around the bush any longer about how to set things right .
cette façon de procéder permet à les Indiens de participer à le activité économique .	it says that resource impact funding helps Indian people to get a piece of the action .
le un de les grands objectifs de les consultations est de faire en sorte que la relance profite également à tous .	one of the major objectives of these consultations is to make sure that the recovery benefits all .
je pense , monsieur le Président , que le discours de le député de Baie - Comeau était probablement de la fausse représentation .	Mr. Speaker , I think that in his speech , the Hon. Member from Baie - Comeau misrepresented reality .
la justice élémentaire exige que les emplois de les femmes soient évalués équitablement .	it is a matter of elementary justice that women 's jobs be fairly evaluated .
nous comptons poursuivre ces discussions en tirant parti de les opinions exprimées par de nombreux groupes intéressés .	we intend to continue this discussion with the benefit of the views of a wide range of interested parties .
je pense surtout à les mères célibataires .	i think particularly of single parents .
le ministre de le Expansion économique régionale traite avec énormément de justice et de honnêteté les dossiers de le Québec .	the Minister of Regional Economic Expansion treats all matters related to Quebec with a great deal of fairness and honesty .
en fait , le revenu agricole net était à son plus bas niveau depuis 1970 et à son troisième plus bas niveau depuis 1938 , soit en 45 ans .	as a matter of fact that net farm income reached its lowest level since 1970 and the third lowest level since 1938 , some 45 years ago .
dans la région de Laval - Deux - Montagnes , 225,000 dollars de budget en 1984 , 30,000 dollars seulement cette année .	in the Laval - Deux - Montagnes area , $ 225,000 was spent in 1984 but only $ 30,000 will be spent this year Mr. Speaker .
ce même ministre a lui - même promis durant la campagne électorale que non seulement il consulterait les pêcheurs mais que il serait facilement accessible en cas de problème .	this particular Minister made personal election promises that he would not only consult with fishermen but that he would be readily available when problems arise .
on néglige actuellement de investir dans ce domaine , surtout en Colombie - Britannique .	that investment is being neglected , primarily in British Columbia .
le pire , ce est que on ne a pas su obtenir une garantie de financement par la voie de une Entente de développement économique régional .	the outstanding issue has been the failure to make a funding commitment for the ERDA agreement .
il devrait parler sincèrement à le lieu de nous servir tout ce charabia .	he should come clean on this issue this afternoon instead of giving us all this gobbledy - gook .
il a dit que British Telecom « ne se était guère montrée habile sur le plan de la commercialisation ou de la gestion de les produits » .	he said that British Telecom « has not demonstrated its marketing savvy or product management ability » .
les investisseurs étrangers menaient le Canada comme se il se était agi de le cinquante - et - unième État .	foreign investment was running Canada as though it were the fifty - first State .
elle ne fait pas de recherche et de développement .	it does not conduct research and development .
la première question consiste à savoir pourquoi il faut stabiliser les prix dans le industrie agricole .	the first question is : why does agriculture require stabilization ?
en règle générale , tous les producteurs de une denrée quelconque subissent en même temps le contrecoup de le resserrement de le étau coût - prix .	as a general rule , all the producers of any given commodity are affected simultaneously by a cost - price squeeze .
ce est donc une circonscription très diversifiée .	we have a diversified riding .
le véritable problème est donc que les agriculteurs abandonnent .	so the real problem is that farmers are leaving farming .
venons - en à ce qui semble être le opinion publique sur la réforme de le Sénat .	let us go to the question of what the public seems to be saying on this issue of Senate reform .
ce est ce que il faut et ce est le objectif visé par le gouvernement .	as this is what is required , it is the target the Government has in mind .
je pense que , indépendamment de notre parti , nous trouvons tous cela inacceptable .	that , I believe , we all find unacceptable , regardless of political Party .
revenons maintenant à le projet de loi en question .	let me return to the Bill which is before us .
ce que les conservateurs proposent de faire pour donner un caractère distinctif à leur projet de loi est une erreur .	it is a mistake to do what the Tories are proposing to do to differentiate their Bill .
et on sait comment cela peut être pénible pour de les gens qui vivent une période pas spécialement drôle de leur vie .	we know how painful that can be for people who are going through a period of their life which is not particularly joyful .
par conséquent , la création de un tel système devrait être la première priorité dans toutes les provinces où il ne en existe pas .	the establishment of such a system should therefore be a priority in each province where it does not already exist .
nous sommes collègues depuis longtemps .	we have been colleagues for a long time .
elle aidera les sociétés canadiennes à redresser plus rapidement leur situation financière en attirant de nouveaux capitaux propres .	it will help Canadian companies to accelerate their return to a healthy financial position by attracting new equity investment .
le universalité de les allocations familiales est maintenue .	the universal family allowance is maintained .
la recherche ne est guère considérée comme prioritaire .	research is a low priority .
ah , bon ?	oh ?
ainsi , le savon et les boissons pour les enfants coûteront davantage , de même que les aliments pour animaux domestiques , le essence et le chauffage domestique .	there are increased costs for shampoo and drinks for kids , pet food , gas , and even heating the home .
cette technique ne a rien de anormal .	this technique is not unusual on the basis of precedents .
de après le dernier budget libéral , de autre part , le revenu personnel avait augmenté de 7 % en 1984 .	similarly , under the last Liberal Budget , personal income increased in 1984 by 7 per cent .
le gouvernement dépense largement et renfloue les entreprises .	but the Government treats itself to lavish spending and engages in bailing out corporations .
les femmes profiteront de nouveaux règlements concernant les prestations de survivant et le partage de les pensions entre les conjoints en cas de rupture de le mariage .	there will be improved survivor benefit regulations for women , standards for pension benefit splitting on marriage breakdown , and equality standards .
en réalité , si on tient compte de le Accord de le Ouest , il est plutôt probable que ce sera 2.8c . le litre .	in fact , if one adds in some other things resulting from the Western Accord , I think it is more likely to be 2.8 cents per litre .
nous respectons nos promesses électorales .	we follow through with our election pledges .
nous devons remonter le économie , créer de le emploi , rationaliser les dépenses de le État , administrer plus efficacement .	we must revive our economy , create jobs , rationalize government spending , administer with increased efficiency .
cela ne tient guère debout , surtout si le on regarde qui paye .	it does not make a lot of sense , particularly when you look at who is paying .
que feront - ils avec ce capital ?	what will they do with that capital ?
cela équivaut à peu près à les 440 millions de dollars versés à Canadair en le espace de deux ans .	that is roughly equal to the $ 440 million paid to Canadair in two years .
il est ressorti de ces audiences que la grande préoccupation était les gains en capital .	from these hearings , it became obvious that the major concern was capital gains .
il donne à entendre à les particuliers que pendant de trop nombreuses années le gouvernement a décidé pour eux .	it indicates to individual Canadians that for too long Government has made their decisions for them .
dans ce sens - là , je vous dirai que je ai rencontré dernièrement de les centaines de jeunes Canadiens , et ils ont perdu beaucoup de illusions .	that brings to mind the hundreds of young Canadians I met recently , most of them quite disillusioned .
ce est pourquoi je ne puis appuyer la demande de emprunt présentée par le gouvernement .	this is why I cannot find myself supportive of the request for additional funding for the Government by way of borrowing .
mon collègue dit « négligé le Québec » , je suis de accord avec lui aussi .	the Hon. Member says : « neglected Quebec » , and I agree .
je suis heureux de apprendre que les sociétés de État qui ont une valeur commerciale mais ne répondent pas à les objectifs de la politique publique soient vendues .	i was glad to hear that Crown corporations with a commercial value but no ongoing public policy purpose will be sold .
lorsque nous avons préparé le budget , nous avons pris cela en considération .	we have taken these considerations very much into account when we designed the Budget .
le premier ministre respectera il cet engagement ?	will the Prime Minister live up to that commitment ?
le ministre pourrait - il préciser les effets de cette réduction ?	can the Minister clarify the effect of the reduction ?
je ne ai parlé jusque ici que de les aspects géographiques de ma circonscription .	thus far , I have been describing the physical aspects of my constituency .
nous pensons que ils relèveront le défi .	we believe they will accept the challenge .
le ministre est - il en mesure de affirmer que cette mesure est équitable ?	can he tell them that is fair ?
il y a longtemps que nos milieux de affaires ne ont pas reçu de un gouvernement un tel vote de confiance .	it has been years and years since our business community got such a vote of confidence from Government .
le parti progressiste conservateur de le Canada se y oppose .	the Progressive Conservative Party of Canada is providing the opposition .
ils se sont levés comme un seul homme pour applaudir bien fort .	they stood to a person and applauded loudly .
huitièmement .	eight .
non , monsieur le Président , à le contraire .	no , Mr. Speaker , not quite .
je voudrais maintenant vous parler un peu de ce qui a motivé la suppression de le impôt sur les gains en capital .	i would like now to go into the theory behind the removal of capital gains tax .
cette initiative va augmenter la pauvreté chez les personnes les plus vulnérables , les personnes âgées , qui ne pourront pas trouver de autres sources de revenu .	it will increase poverty in the most vulnerable people , senior citizens , who will not be able to go out and find other sources of income .
en outre , sont stationnés sur cette base , les Snow Birds , le équipe de acrobatie aérienne de le Canada .	CFB Moose Jaw is also the home of the Snowbirds , Canada 's aerobatic air team .
notre caucus a entendu le autre jour le Conseil économique de les provinces de le Atlantique .	our caucus heard the other day from the Atlantic provinces economic council .
faut pas nous prendre pour de les poires !	come on , give us a break !
il se agit de un problème important .	that is one major problem .
je ai le intention de parler surtout aujourd' hui de les nombreuses améliorations apportées à les programmes de pensions de tous les Canadiens .	i wish to direct the majority of my comments today to the many improvements offered in the pension programs available to all Canadians .
on estimait également que il fallait compenser le érosion de la valeur de les biens due à le inflation .	furthermore , the erosion of the cost base of assets by inflation was also regarded as something that should be compensated for .
il démontre une attitude réaliste , également parce que il agit avec douceur et intelligence .	the Budget is realistic because it takes a balanced and sensible approach .
le gouvernement ne se y intéresse pas et il ne se en soucie pas .	that is not the interest or concern of this Government .
ils ont voté pour un changement dans la gestion de les affaires de le pays .	they voted for a change in the national affairs of our nation .
monsieur le Président , un rappel à le Règlement .	on a point of order , Mr. Speaker .
les faits sont clairs et nets .	the facts are clear .
aussi la motion de le député de Beaches nous permet de faire en cette Chambre ce que tout le monde fait présentement à travers le pays .	the motion of the Hon. Member for Beaches therefore gives us an opportunity to do in this House what everyone else is now doing throughout the country .
de plus , ils ont une bibliothèque spécialisée à leur service et la société ERCO dépense près de deux millions chaque année pour ses services de recherche .	they also have a technical library , and the company spends nearly $ 2 million annually on these research services .
deuxièmement , il faut aider les entreprises canadiennes à tirer parti de les possibilités de investissement et de le développement technologique .	second , we want to assist Canadian businesses to exploit opportunities for investment and technological advancement .
non seulement les risques sont plus élevés , mais le temps nécessaire pour préparer le réapprovisionnement par navire est long .	not only are the risks greater but the time required to prepare for marine re - supply is lengthy .
monsieur le Président , une fois encore , les prévisions pessimistes de les libéraux et de les néo - démocrates en matière économique ne se sont pas concrétisées .	Mr. Speaker , once again the Liberal and NDP forecasters of economic doom and gloom have been proven wrong .
je ne ai pas le intention de ennuyer la Chambre en répétant les mêmes réponses .	i am not going to bother boring the House with those answers again .
cependant , lorsque nous avons pris le pouvoir , nous avons découvert que la tendance était à la hausse .	however , when we came into office we discovered that the trend line was going up .
rien ne oblige non plus un ministre à déposer autre chose que le document dont il a tiré une citation .	only the document cited need to be tabled by a Minister .
en outre , il est stipulé dans notre résolution que il faudrait avoir servi plus de 365 jours à le Canada pour être admissible .	furthermore , there is the provision in our resolution of having had to serve for a period in excess of 365 days in Canada as the basis of eligibility .
le gouvernement avait alors prétendu que il ne avait pas eu le temps de discuter de ce projet avec le un ou le autre de ces deux groupes .	the Government said that it had not had time to talk to either group about that proposal .
autrement dit , notre destin économique est scellé .	in other words , the writing is on the wall .
ils disaient que les propriétaires allaient encore écoper parce que les taux de intérêt augmentaient .	they were saying that homeowners would lose again because interest rates were rising .
notre rôle sur la scène internationale est quelque peu éclipsé .	our international role has somehow collapsed .
en ce qui concerne le assurance - récolte , par exemple , le gouvernement fédéral a contribué la moitié de les primes et les producteurs le autre moitié .	for instance , if we look at crop insurance , the federal Government has put up half the premiums and the producers have put up the other half .
donc , il est impossible pour nous de penser en ces termes .	so we cannot think in those terms .
elle a déclaré que le seul problème que posent le Candu et toute le option nucléaire , ce est sur le plan de la commercialisation .	the Minister has said that the only problem with Candu and the whole nuclear power option is a marketing one .
comment se faisait - il que le on me présentait toutes ces instances ?	why was it that I was receiving those kind of representations ?
» ce est cela que le actuel premier ministre avait dit à le ancien premier ministre .	» that is what the present Prime Minister told the former Prime Minister .
la majorité sont de ailleurs incapables de travailler .	most of them are unable to work .
il y a quelques jours , mon collègue de Essex - Windsor a donné à la Chambre une leçon de histoire .	a few days ago my colleague from Essex - Windsor gave the House a history lesson .
voici le texte de le article :	the article reads :
il se chauffait à le mazout .	he said that he was burning oil .
le gouvernement ne a pas encore décidé comment et quand cette modification devrait se manifester .	the Government has yet to come to the point of determining how and when this change should take place .
je ai parlé tantôt de le pari de le premier ministre ( M. Mulroney ) concernant le emploi en immigration .	i referred earlier to the bet taken up by the Prime Minister ( Mr. Mulroney ) concerning employment as related to immigration .
cependant , le projet de loi dont nous sommes saisis aujourd' hui ne contient que deux amendements de fond et un certain nombre de amendements de ordre administratif .	however , we see in the legislation before us today only two substantive amendments and a number of housekeeping amendments to the Bill .
il ne nous est pas permis en tant que société de faire ce genre de discrimination entre les gens en fonction de un pareil critère .	we as a society cannot afford to discriminate among individuals on that sort of basis .
une collaboration entre le gouvernement fédéral et les provinces est indispensable pour accroître la valeur et le efficacité de nos programmes de dépistage .	this type of federal - provincial co - operation is required to increase the sensitivity and efficiency of our current disease surveillance systems .
selon lui , il vaudrait mieux attendre à le moins jusque en juin .	he suggested that June at least would be a better time .
le entreprise , tout en demeurant dans le secteur privé , fut rebaptisée en 1934 la Société de les transports de le nord Limitée .	in 1934 , the company was renamed the Northern Transportation Company Limited , still under private ownership .
je félicite sincèrement le ministre de les Transports de avoir respecté le mandat initial .	i do commend the Minister of Transport for following through on the original terms of reference .
ce ne est que aujourd' hui que le secteur privé fait savoir que il ne est pas en mesure de soutenir la concurrence de toutes ces sociétés de État .	then and only then does the private sector rush in saying that it cannot have all these publicly - owned corporations interfering in the private sector .
les services spécialisés , comme le ravitaillement de le secteur pétrolier et gazier de la mer de Beaufort , pourraient être assurés par de autres .	specialty services such as stand - by supply vessels for the Beaufort Sea oil and gas industry can be provided by others .
malheureusement ou heureusement , selon le point de vue de chacun , ce ministre ne a guère obtenu de succès .	unfortunately or fortunately , however one views the issue , that particular Minister has not met with very much success .
toutefois , la présidence pourrait peut - être en terminer avec la motion no 1 .	however , perhaps the Chair could dispose of Motion No. 1 .
sur la côte ouest , nous avons le comité consultatif de le ministre qui , même se il ne est pas parfait , peut à le moins être utile .	on the west coast we have the Minister 's Advisory Committee which , while not perfect , is at least of assistance .
voilà un excellent exemple de association fructueuse entre les gouvernements et le industrie .	this is a fine example of a partnership in progress between government and industry .
monsieur le Président , je ai une question à poser à le ministre de les Transports .	Mr. Speaker , my question is directed to the Minister of Transport .
monsieur le Président , je ne veux pas que il y ait de malentendu .	Mr. Speaker , let me be clear .
À le sein de le gouvernement de le Canada , divers ministères ont joué un rôle actif et sont intervenus dans le cadre de une action coordonnée et coopérative .	within the Government of Canada , a number of Departments have been actively involved and have been proceeding in a co - operative and coordinated fashion .
toutefois , la contradiction qui existe entre sa déclaration et celle de ses hauts fonctionnaires devrait faire le objet de une enquête indépendante .	however , the contradiction between what he said and what has been said by his officials requires further independent investigation .
je sais que nous nous en occupons à le niveau fédéral par le intermédiaire de la Société de le crédit agricole .	i know that we are trying to do it , at the federal level through the Farm Credit Corporation .
tels sont les principaux indices économiques .	these are key economic indicators .
le établissement de une sixième exploitation agricole à Bowden , en Alberta , permettra de accroître encore la production agricole de les établissements carcéraux .	production is being expanded with the development of a sixth farm at Bowden Institution in Alberta .
tel était le principe de ce projet de loi à le étape de la deuxième lecture .	that was the principle of the Bill as passed on second reading .
certes , personne , et surtout pas un seul député conservateur , ne y croirait .	surely no one , and particularly no member of the Conservative Party , would believe that .
ce est ce que elle a fait le 4 septembre dernier .	the people of Canada did that on September 4 .
Convoquez les députés .	call in the Members .
nous croyons que il est temps de établir de les règlements et de les méthodes comme il se doit .	we think that now is the time for the regulations and procedures to be properly established .
leur intervention était tout à fait justifiée , car le succès de ces accords dépendra dans une très large mesure de la qualité de leur administration .	the point was well taken because the success of these agreements will depend to a considerable degree upon the quality of their administration .
le Canada a tout lieu de être fier de son bilan dans ce domaine et devrait servir de modèle de tolérance pour les autres pays .	canada can be proud of its record on human rights and should serve as an example of tolerance to other countries .
sur le avis de qui a il pris cette décision , puisque ses services avaient refusé ?	whose advice did he follow in making his decision , in that his officials rejected it ?
monsieur le Président , je suis heureuse que le premier ministre ait fourni ces informations à la Chambre .	Mr. Speaker , I am pleased that the Prime Minister has provided the information in the House .
je prie donc le député de cesser de montrer quoi que ce soit .	may I therefore ask the Hon. Member to refrain from any further displays .
pourquoi le premier ministre se est - il montré prêt à manquer à sa promesse en premier lieu ?	why did the Prime Minister appear prepared to disregard his promise in the first place ?
monsieur le Président , ces questions inquisitrices de le parti libéral me font toujours sourire .	Mr. Speaker , I am always amused by these probing questions from the Liberal Party , the Party which says that it would control the deficit .
assurément , le député ne voudrait pas que le on impose de les sociétés qui perdent de le argent .	surely the Hon. Member is not suggesting that we levy taxes on companies that have been losing money .
monsieur le Président , la question de le député part de une hypothèse toute gratuite .	Mr. Speaker , the premise of the question put by the Hon. Member is wrong .
combien de personnes sont employées a ) directement ou à contrat , b ) à temps plein et à temps partiel à le Bureau de le premier ministre ?	how many people are employed ( a ) directly or by contract ( b ) full time and part time , in the Office of the Prime Minister ?
les cachets versés à chacun étaient conformes à le rôle joué pendant le gala et respectaient les normes de le Union de les artistes .	the fees paid to each performer were in keeping with the role played in the gala and with the standards of the Union des Artistes .
sous le gouvernement libéral , rien ne a été fait pour remédier à cette situation .	during the Liberal administration nothing was done about it .
ils connaissent très bien le problème de surproduction .	they know about the overproduction problem .
hansard RÉVISÉ * NUMÉRO 1	edited HANSARD * NUMBER 1
le lundi 22 septembre 1997	Monday , September 22 , 1997
PREMIÈRE SESSION - 36E LÉGISLATURE	first SESSION - 36 TH PARLIAMENT
ouverture de le Parlement	opening of Parliament
le greffier de la Chambre	the Clerk of the House
ÉLECTION DU PRÉSIDENT	election OF SPEAKER
le président de élection (M. Caccia )	the Presiding Officer ( Mr. Caccia )
suspension de la séance	suspension of Sitting
le président de élection (M. Caccia )	the Presiding Officer ( Mr. Caccia )
reprise de la séance	sitting Resumed
le président de élection (M. Caccia )	the Presiding Officer ( Mr. Caccia )
suspension de la séance	suspension of sitting
reprise de la séance	sitting resumed
suspension de la séance	suspension of Sitting
reprise de la séance	sitting Resumed
le président de élection (M. Caccia )	the Presiding Officer ( Mr. Caccia )
suspension de la séance	suspension of Sitting
reprise de la séance	sitting Resumed
le président de élection (M. Caccia )	the Presiding Officer ( Mr. Caccia )
m . John Nunziata	Mr. John Nunziata
ouverture DE LA SESSION	opening OF SESSION
( version officielle )	( official Version )
hansard RÉVISÉ * NUMÉRO 1	edited HANSARD * NUMBER 1
chambres DES COMMUNES	house OF COMMONS
le lundi 22 septembre 1997	Monday , September 22 , 1997
PREMIÈRE SESSION - 36E LÉGISLATURE	first SESSION - 36 TH PARLIAMENT
la trente - cinquième législature ayant été prorogée et les Chambres dissoutes par proclamation le dimanche 27 avril 1997 , puis les brefs ayant été émis et rapportés , les nouvelles Chambres ont été convoquées pour le expédition de les affaires le lundi 22 septembre 1997 et , en conséquence , se sont réunies le jour dit .	the 35 th Parliament having been dissolved by proclamation on Sunday , April 27 , 1997 , and writs having been issued and returned , a new Parliament was summoned to meet for the dispatch of business on Monday , September 22 , 1997 , and did accordingly meet on that day .
le lundi 22 septembre 1997 .	Monday , September 22 , 1997
le Parlement ayant été convoqué pour aujourd' hui , par proclamation de Son Excellence le Gouverneur général de le Canada pour le expédition de les affaires , et les députés étant réunis :	this being the day on which Parliament was convoked by proclamation of His Excellency the Governor General of Canada for the dispatch of business , and the members of the House being assembled :
m . Robert Marleau , greffier de la Chambre , donne lecture de une lettre de le directeur administratif de le Gouverneur général annonçant que le très honorable Antonio Lamer , à titre de suppléant de le Gouverneur général , se rendra à la salle de le Sénat le lundi 22 septembre 1997 , à Ottawa , pour ouvrir la première session de la trente - sixième législature .	Robert Marleau , Esquire , Clerk of the House of Commons , read to the House a letter from the Administrative Secretary to the Governor General informing him that the Right Honourable Antonio Lamer , in his capacity as Deputy Governor General , would proceed to the Senate chamber to open the first session of the 36 th Parliament of Canada on Monday , September 22 at Ottawa .
le gentilhomme huissier de la verge noire apporte le message suivant :	a message was delivered by the Gentleman Usher of the Black Rod as follows :
membres de la Chambre de les communes :	members of the House of Commons :
ce est le désir de le honorable suppléant de Son Excellence le Gouverneur général que cette honorable Chambre se rende immédiatement auprès de lui dans la salle de le honorable Sénat .	it is the desire of the Honourable the Deputy to His Excellency the Governor General of Canada that this honourable House attend him immediately in the chamber of the honourable the Senate .
honorables membres de le Sénat , membres de la Chambre de les communes :	honourable Members of the Senate , Members of the House of Commons :
je suis chargé de vous informer que Son Excellence le Gouverneur général de le Canada ne juge pas à propos de faire connaître , avant que la Chambre de les communes ne ait choisi un Président conformément à la loi , les motifs qui le ont porté à convoquer le Parlement , mais que il les exposera demain le mardi 23 septembre 1997 , à 14 h 30 .	i have it in command to let you know that His Excellency the Governor General of Canada does not see fit to declare the causes of his summoning the present Parliament of Canada until a Speaker of the House of Commons shall have been chosen , according to law ; but tomorrow , Tuesday , September 23 , 1997 at 2.30 in the afternoon , His Excellency will declare the causes of his calling Parliament .
et les députés étant revenus à la Chambre de les communes .	and the House being returned to the Commons chamber .
le greffier de la Chambre :	the Clerk of the House :
conformément à le article 3 de le Règlement , je inviteM. Caccia , député de la circonscription de Davenport , à venir prendre place à le fauteuil afin de présider à le élection de un Président .	pursuant to Standing Order 3 , I invite Mr. Caccia , member for the electoral district of Davenport , to take the chair and preside over the election of a Speaker .
ÉLECTION DU PRÉSIDENT	election OF SPEAKER
le président de élection (M. Caccia ) :	the Presiding Officer ( Mr. Caccia ) :
chers collègues , vous me faites un grand honneur en me confiant cette tâche .	it is indeed a great honour to be entrusted with this task .
en ce premier jour de automne , je aimerais souhaiter la plus cordiale bienvenue à tous les députés et surtout à les 90 nouveaux parlementaires siégeant en cette Chambre , laquelle compte maintenant 301 sièges .	on this first day of autumn I would like to extend a most cordial welcome to all , in particular to the 90 newly elected parliamentarians who are now sitting in the House , which has been extended to 301 seats .
six nouveaux sièges ont été ajoutés à la Chambre de les communes afin que elle reflète adéquatement le nombre croissant de électeurs canadiens .	six seats have been added to reflect the increasing number of Canadian electors .
la tâche qui nous attend aujourd' hui est simple et précise : élire un Président , conformément à les dispositions de les articles 2 à 6 de le chapitre 1 de le Règlement .	the task we have ahead of us today is very simple and straightforward , to elect a Speaker according to the terms of Standing Orders 2 through 6 in chapter 1 .
je voudrais attirer le attention de les députés sur le fait que , en vertu de le Règlement , nous allons commencer avec la liste de les candidats et , tout de abord , celle de les députés qui ont retiré leur candidature ou qui ne sont pas éligibles .	i draw the attention of hon. members to the fact that pursuant to the standing orders , we will begin with the list of candidates , but first with the list of members who have withdrawn or who are ineligible as candidates .
la liste de les députés éligibles à la Présidence a également été déposée sur le pupitre de chaque député .	the list of eligible members has also been placed on each member ' s desk .
elle est disponible à le Bureau et elle est affichée dans chaque isoloir .	it is available at the table and posted at each voting station .
lorsque le greffier aura ouvert les bulletins , la présidence proposera une méthode pour accélérer le processus de scrutin .	after the Clerk has unsealed the ballots , the Chair will suggest a method of proceeding which will help to accelerate the voting process .
comme nous allons maintenant commencer à voter , je rappelle à les honorables députés que ils doivent écrire le prénom et le nom de leur candidat en lettres moulées sur le bulletin de vote .	as we are now going to commence voting , I would remind the honourable members to print the first and last names of their candidate on the ballot paper .
je propose que les députés quittent leur fauteuil , sortent par derrière les rideaux et viennent à la table en utilisant les portes à droite et à gauche de le fauteuil présidentiel , selon le côté où ils siègent .	i suggest that members leave their desk , exit through the curtains and come to the table using the doors on the left and right sides of the chair on their respective sides of the House .
le greffier donnera un bulletin à chaque député .	the Clerk will issue to each member a ballot paper .
après avoir voté , les députés voudront bien se éloigner de les isoloirs .	will the hon. members please leave the voting area after voting .
les isoloirs sont maintenant ouverts pour le vote .	the polling booths are now open to vote .
les députés peuvent maintenant se avancer pour voter .	the polling booths are now open .
( les députés reçoivent leur bulletin de vote , que ils remplissent en secret dans les isoloirs . )	( members were issued ballots and marked their ballots in secret at voting stations )
le président de élection (M. Caccia ) :	the Presiding Officer ( Mr. Caccia ) :
les députés qui ne ont pas voté et qui souhaitent le faire devraient voter maintenant .	if there are any hon. members who have not voted and wish to do so , will they please vote now .
tous les députés ayant voté , je ordonne à le greffier de procéder à le dépouillement de le scrutin une fois que je aurai déposé mon bulletin de vote .	all members having voted , I do now instruct the Clerk to proceed with the counting of the ballots after I have cast my ballot .
suspension DE LA SÉANCE	suspension OF SITTING
le président de élection (M. Caccia ) :	the Presiding Officer ( Mr. Caccia ) :
avant de suspendre la séance , je signale à les députés que , lorsque on aura fini de dépouiller les bulletins de vote , on ne fera retentir la sonnerie rappelant les députés à la Chambre que pendant cinq minutes .	before I suspend the sitting may I bring to the attention of hon. members that when the counting of ballots has been completed the bells to call the members back to the House will be sounded for not more than five minutes .
la séance est suspendue jusque à le appel de le Timbre .	the sitting is suspended to the ringing of the bells .
( la séance est suspendue jusque à 12 h 10 . )	( the sitting of the House was suspended at 12.10 p.m. )
reprise DE LA SÉANCE	sitting RESUMED
la séance reprend à 12 h 44 .	the House resumed at 12.44 p.m.
le président de élection (M. Caccia ) :	the Presiding Officer ( Mr. Caccia ) :
je ai le devoir de informer la Chambre que un deuxième tour de scrutin sera nécessaire .	it is my duty to inform the House that a second ballot will be necessary .
les députés éligibles à le deuxième tour de scrutin sont les suivants :	the following members are eligible for the second ballot :
si le un de les députés que je viens de nommer désire retirer sa candidature , que il veuille bien nous faire part de les motifs de sa décision .	if any member whose name I have just read wishes to withdraw as a candidate for the second ballot , will that member please rise in his place and state the reason ?
les noms que je viens de mentionner figurent sur le deuxième bulletin de vote .	the names just announced are on the second ballot .
dans quelques instants , le greffier pourra présenter la liste de les candidats .	in a few minutes the Clerk will be able to provide that list .
le vote aura lieu à ce moment - là .	at that moment the voting will commence .
pendant que le greffier descelle le paquet de bulletins de vote , je informe la Chambre que le deuxième bulletin sera de une couleur différente et que la liste de les noms de les candidats à ce tour de scrutin a été déposée dans chaque isoloir .	while the Clerk is unsealing the ballots , the Chair would like to indicate that the second ballot will be of a different colour and that the list of names of candidates on this ballot has been placed in each polling station .
je voudrais aussi signaler à les députés que ils peuvent maintenant se avancer pour voter .	i would also like to point out that the polling booths are now open .
les isoloirs sont maintenant ouverts .	the polling booths are now open .
( les députés reçoivent leur bulletin de vote , que ils remplissent en secret dans les isoloirs . )	( members were issued ballots and marked their ballots in secret at voting stations )
le président de élection (M. Caccia ) :	the Presiding Officer ( Mr. Caccia ) :
À le ordre , se il vous plaît .	order , please .
si personne de autre ne souhaite voter ou déposer un bulletin de vote , je ordonne à le greffier de procéder à le dépouillement de le scrutin .	if there are no more members in the chamber wishing to vote or cast a ballot , I instruct the Clerk to proceed with the counting of the ballots .
suspension DE LA SÉANCE	suspension OF SITTING
le président de élection (M. Caccia ) :	the Presiding Officer ( Mr. Caccia ) :
À le ordre , se il vous plaît .	order , please .
avant de suspendre la séance , je signale à les honorables députés que après le dépouillement de le scrutin , la sonnerie de appel de les députés à la Chambre retentira pendant à le plus cinq minutes .	before I suspend the sitting may I bring it to the attention of hon. members that , when the counting of ballots has been completed , the bells to call the members back to the House will be sounded for not more than five minutes .
( la séance est suspendue à 13 h 13 . )	( the sitting of the House was suspended at 1.13 p.m. )
reprise DE LA SÉANCE	sitting RESUMED
la séance reprend à 13 h 42 .	the Presiding Officer ( Mr. Caccia ) :
le président de élection (M. Caccia ) :	order , please .
je ai le devoir de informer la Chambre que il faudra tenir un troisième tour de scrutin .	it is my duty to inform the House that a third vote will be necessary .
voici les noms de les candidats pour le troisième tour :	the names of members eligible for the third ballot are as follows :
si le un de les députés que je viens de nommer désire retirer sa candidature , que il veuille bien le faire maintenant .	if any member whose name I have just read wishes to withdraw as a candidate for the third ballot , would he please rise in his place and do so ?
À le ordre , se il vous plaît .	order , please .
pendant que le greffier descelle le paquet de bulletins de vote , je rappelle à les députés que les bulletins de vote pour ce troisième tour de scrutin sont de une couleur différente et que la liste de les candidats est affichée dans chaque isoloir .	while the Clerk is unsealing the ballots , may I remind members that the ballots for the third vote will be a different colour and that the list of names of candidates on this ballot has been placed in each polling station .
le vote peut commencer maintenant .	the polling booths are now open .
les députés peuvent maintenant se avancer pour voter .	the Hon. members may now come and vote .
( les députés reçoivent leur bulletin de vote , que ils remplissent en secret dans les isoloirs . )	( members were issued ballots and marked their ballots in secret at voting stations )
le président de élection (M. Caccia ) :	the Presiding Officer ( Mr. Caccia ) :
dès que le président aura voté , le greffier procédera à le dépouillement de le scrutin .	after the Chair casts a vote the Clerk will proceed with the counting of the ballots .
suspension DE LA SÉANCE	suspension OF SITTING
le président de élection (M. Caccia ) :	the Presiding Officer ( Mr. Caccia ) :
avant de suspendre la séance , je précise à les députés que , lorsque on aura fini de dépouiller les bulletins de vote , on ne fera retentir la sonnerie rappelant les députés à la Chambre que pendant cinq minutes .	before suspending the sitting I bring to the attention of the honourable members that when the counting has been completed , the bells to call the members back to the house will be sounded for not more than five minutes .
la séance est suspendue jusque à le appel de la présidence .	the sitting is suspended to the call of the Chair .
( suspension de la séance à 14 h 6 . )	( the sitting of the House was suspended at 2.06 p.m. )
reprise DE LA SÉANCE	sitting RESUMED
la séance reprend à 14 h 29 .	the House resumed at 2.29 p.m.
le président de élection (M. Caccia ) :	the Presiding Officer ( Mr. Caccia ) :
À le ordre .	order .
je ai le devoir de informer la Chambre que un quatrième tour de scrutin sera nécessaire .	it is the duty of the Chair to inform this House that a fourth ballot will be necessary .
les noms de les députés éligibles à le prochain tour de scrutin sont les suivants :	the names of members eligible for the next ballot are as follows :
afin de faciliter les choses , une liste alphabétique révisée de les candidats pour le prochain tour sera placée dans chaque isoloir de ici quelques minutes et le vote pourra alors commencer .	for the benefit of hon. members , a revised alphabetical list of candidates for the next ballot will be placed in each polling station within the next few minutes at which time the voting will commence .
ce bulletin de vote sera de une couleur différente .	this ballot will be of a different colour .
la liste de les candidats pour ce tour a été placée dans chaque isoloir .	the list of candidates on this ballot has been placed in each polling station .
le greffier est en train de desceller le paquet de bulletins de vote et les isoloirs sont maintenant ouverts .	the Clerk is unsealing the ballots and the polling booths are now open .
les députés peuvent maintenant se avancer pour voter .	the polling booths are now open .
( les députés reçoivent leur bulletin de vote , que ils remplissent en secret dans les isoloirs . )	( members were issued ballots and marked their ballots in secret at voting stations . )
le président de élection (M. Caccia ) :	the Presiding Officer : ( Mr. Caccia ) :
se il se trouve de les députés qui ne ont pas encore voté et qui souhaitent le faire , je les prie de se avancer immédiatement .	if there are any hon. members who have not voted and wish to do so , will they please vote now ?
je demanderai maintenant à le greffier de la Chambre de procéder à le dépouillement de le scrutin lorsque je aurai moi - même voté .	i now instruct the Clerk to proceed with the counting of the ballots after I have cast my ballot .
suspension DE LA SÉANCE	suspension OF SITTING
le président de élection (M. Caccia ) :	the Presiding Officer ( Mr. Caccia ) :
avant de suspendre la séance , je signale à les honorables députés que après le dépouillement de le scrutin , la sonnerie de appel de les députés à la Chambre retentira à le plus cinq minutes .	before suspending the sitting , may I bring to the attention of members that when the counting of the ballots has been completed , the bells to call the members back to the House will be sounded for not more than five minutes .
( la séance est suspendue à 14 h 58 . )	( the sitting of the House was suspended at 2.58 p.m. )
reprise DE LA SÉANCE	sitting RESUMED
la séance reprend à 15 h 18 .	the House resumed at 3.18 p.m.
le greffier de la Chambre ayant communiqué à le président de élection le nom de le député ayant recueilli la majorité de les voix :	( the Clerk of the House having provided the Presiding Officer with the name of the member having received a majority of the votes cast : )
le président de élection (M. Caccia ) :	the Presiding Officer ( Mr. Caccia ) :
je ai le devoir de informer la Chambre que un Président de la Chambre a été élu .	it is my duty to inform the House that the Speaker of this House has been duly elected .
ce est avec grand plaisir que je invite maintenant le honorable député de la circonscription électorale de Niagara - Centre , M. Gilbert Parent , à venir prendre place à le fauteuil .	it is now my great pleasure to invite the hon. member for Niagara Centre , Gilbert Parent , to take the chair now .
de les voix :	some hon. members :
bravo !	hear , hear .
( la masse ayant été placée sous la table , le président de élection quitte le fauteuil et y conduitM. Parent )	the Presiding Officer , having vacated the chair , and the mace having been laid under the table , conducted Mr. Parent from his seat in the House to the chair .
le Président :	the Speaker :
je tiens à commencer par répéter les premiers mots que , depuis de les centaines de années , tous les Présidents prononcent .	i did not want to begin this without saying the words that all Speakers have used for hundreds of years now .
honorables députés , je tiens à exprimer à la Chambre mes humbles remerciements pour le grand honneur que elle a bien voulu me faire en me choisissant comme Président .	hon. members , I beg to return my humble acknowledgements to the House for the great honour you have been pleased to confer upon me by choosing me to be your Speaker .
je tiens à vous remercier de la confiance que vous venez de me témoigner .	i want to thank you , my colleagues , for your vote of confidence today .
je suis à la fois très reconnaissant et profondément touché .	it is very much appreciated and I take it to heart .
il se en trouve pour dire que il y aura beaucoup de action à la Chambre à le cours de cette 36e législature .	there are some who say this House will be lively in the 36 th Parliament .
je ne ai jamais connu de législature où il ne y avait pas beaucoup de action .	i have never been in a Parliament that has not been lively .
pourquoi ne y aurait - il pas beaucoup de action ?	why should it not be ?
vous êtes ici en tant que les porte - parole élus de les Canadiens de tout le pays .	you have come here because you have been chosen to be the spokespersons for Canadians across the land .
vous allez défendre comme il se doit de les opinions bien arrêtées .	you are going to hold strong opinions , and as well you should .
ce est ici , sur le parquet de la Chambre de les communes , que nous aurons la chance de nous exprimer .	and it is here , on the floor of the House of Commons , that we will have a chance to express our views .
la dernière fois que vous me avez fait le honneur de me élire comme Président , je ai dit que nous étions les gladiateurs politiques de le Canada , et ce est vrai .	the last time I had the honour to be elected your Speaker I said that we are the political gladiators of Canada , and we are .
nos armes sont nos paroles , nos idées , nos convictions .	our weapons are our words , our ideas , our beliefs .
voilà pourquoi il y a de le action .	that is why things are lively .
mais nous pouvons faire notre travail dans un esprit de respect le un pour le autre et pour notre institution .	however , we can do our job in a spirit of respect for one another and for this institution .
mon travail est de veiller à ce que les droits et privilèges de tous les parlementaires canadiens soient protégés .	my task is to see to it that the rights and privileges of all of you parliamentarians of Canada are protected .
de une manière générale , nous avons , vous et moi , trois droits et privilèges fondamentaux .	generally speaking we have , you and I , three basic rights and privileges .
nous avons le droit de venir à cet endroit .	we have the right to come to this place .
nous avons le droit de parler sans crainte , et celui de voter .	we have the right to speak unafraid and we have the right to vote .
je vous promets de exécuter mes fonctions dans un esprit de équité et de impartialité .	i pledge to you that I will carry out my duties in a spirit of fairness and impartiality .
je suis , comme vous le savez , à le service de la Chambre .	i am , as you know , a servant of this House .
ce est la Chambre qui , collectivement , décide si elle veut apporter de les changements et de quelle manière elle procédera à ces changements .	it is the House collectively that makes decisions as to whether it wants to change and how it will change .
parlementaires de le Canada , à le cours de les prochaines années , en raison de la situation , de le histoire et , oui , de le destin , le sort de notre pays sera entre nos mains .	parliamentarians of Canada , for the next few years because of circumstance , because of history and yes , because of destiny , the fate of our nation will rest in our hands .
je vous remercie de nouveau pour le honneur que vous me avez fait aujourd' hui .	my dear colleagues , thank you again for the honour that you have bestowed on me today .
et maintenant , le Parlement peut se mettre à le travail .	and now , on to the work of this Parliament .
je vous remercie beaucoup .	i thank you very much .
de les voix :	some hon. members :
bravo !	hear , hear .
et la masse ayant été posée sur la table :	and the mace having been laid upon the table :
m . John Nunziata ( York - Sud - Weston , Ind . ) :	Mr. John Nunziata ( York South - Weston , Ind . ) :
monsieur le Président , je voudrais profiter de le occasion pour vous exprimer mes plus sincères félicitations à le occasion de votre élection .	Mr. Speaker , I want to take this opportunity to extend to you my most sincere congratulations on your election .
comme vous le savez , à le fil de les ans , je ai acquis un grand respect pour vous .	as you know , over the years I have had considerable respect for you .
je vous considère comme un ami .	i have considered you a friend .
de le fond de le coeur , je vous félicite .	from the bottom of my heart , congratulations to you .
je voudrais également que vous demandiez le consentement de la Chambre pour faire de votre élection un choix unanime .	i would also ask that you seek the consent of the House to make your election unanimous .
le Président :	the Speaker :
la Chambre a entendu le libellé de la motion .	the House has heard the terms of the motion .
les députés appuient - ils la motion ?	do members agree with the terms of the motion ?
de les voix :	some hon. members :
de accord .	agreed .
* * *	* * *
ouverture DE LA SESSION	opening OF SESSION
le Président donne lecture de une lettre de la secrétaire de le Gouverneur général annonçant que Son Excellence le Gouverneur général se rendra à la chambre de le Sénat à 14 h 30 , le mardi 23 septembre 1997 , pour ouvrir officiellement la première session de la trente - sixième législature .	the Speaker read to the House a letter from the Secretary to the Governor General informing him that His Excellency the Governor General would proceed to the Senate chamber on Tuesday , September 23 , 1997 , at 2.30 p.m. to open officially the first session of the 36 th Parliament .
le Président :	the Speaker :
en conséquence , la Chambre se ajourne à demain .	accordingly , the House stands adjourned until tomorrow .
( la séance est levée à 15 h 29 . )	( the House adjourned at 3.29 p.m. )
hansard RÉVISÉ * NUMÉRO 2	edited HANSARD * NUMBER 2
table DES MATIÈRES	contents
le mardi 23 septembre 1997	Tuesday , September 23 , 1997
discours DU TRÔNE	speech FROM THE THRONE
le Président	the Speaker
les SERMENTS De OFFICE	oaths OF OFFICE
projet de loi C - 1 .	bill C - 1 .
présentation et première lecture	introduction and first reading
le trèshon. Jean Chrétien	right Hon. Jean Chr é tien
le DISCOURS DU TRÔNE	speech FROM THE THRONE
le Président	the Speaker
le trèshon. Jean Chrétien	right Hon. Jean Chr é tien
le BUREAU DE RÉGIE INTERNE	board OF INTERNAL ECONOMY
le RÈGLEMENT	standing ORDERS
Lehon. Don Boudria	hon. Don Boudria
le COMITÉ PLÉNIER	committees OF THE WHOLE
nomination de le président	appointment of Chairman
le trèshon. Jean Chrétien	right Hon. Jean Chr é tien
nomination de le vice - président	appointment of Deputy Chairman
le trèshon. Jean Chrétien	right Hon. Jean Chr é tien
nomination de la vice - présidente adjointe	appointment of Assistant Deputy Chairman
le trèshon. Jean Chrétien	right Hon. Jean Chr é tien
motion	motion
les CRÉDITS	supply
Lehon. Don Boudria	hon. Don Boudria
Lehon. Marcel Massé	hon. Marcel Mass é
le DISCOURS DU TRÔNE	speech FROM THE THRONE
adresse en réponse	address in Reply
Mme Sarmite Bulte	Ms. Sarmite Bulte
m . Claude Drouin	Mr. Claude Drouin
m . Preston Manning	Mr. Preston Manning
les TRAVAUX DE LA CHAMBRE	business OF THE HOUSE
Lehon. Don Boudria	hon. Don Boudria
Lehon. Don Boudria	hon. Don Boudria
( version officielle )	( official Version )
hansard RÉVISÉ * NUMÉRO 2	edited HANSARD * NUMBER 2
chambre DES COMMUNES	house OF COMMONS
le mardi 23 septembre 1997	Tuesday , September 23 , 1997
la séance est ouverte à 14 h 30 .	the House met at 2.30 p.m.
prière	prayers
discours DU TRÔNE	speech FROM THE THRONE
le gentilhomme huissier de la verge noire apporte le message suivant :	a message was delivered by the Gentleman Usher of the Black Rod as follows :
monsieur le Président , ce est le désir de Son Excellence le Gouverneur général que cette honorable Chambre se rende immédiatement auprès de elle dans la salle de le honorable Sénat .	Mr. Speaker , His Excellency the Governor General desires the immediate attendance of this honourable House in the Chamber of the Senate .
en conséquence , le Président et les membres de les Communes se rendent à le Sénat .	accordingly , Mr. Speaker with the House went up to the Senate Chamber .
et de retour à la Chambre de les communes :	and the House being returned to the Commons chamber :
le Président :	the Speaker :
À le ordre , se il vous plaît .	order , please .
je ai le honneur de rapporter que les Communes se étant rendues à le Sénat sur le invitation de Son Excellence le Gouverneur général , je ai informé Son Excellence que je avais été désigné Président .	i have the honour to report that , the House having attended on His Excellency the Governor General in the Senate chamber , I informed His Excellency that the choice of Speaker had fallen upon me .
en votre nom , je ai réclamé les privilèges accordés de ordinaire , que il a plu à Son Excellence de bien vouloir confirmer .	on your behalf , I made the usual claim for your privileges which His Excellency was pleased to confirm to you .
je annonce à la Chambre que , suite à le intervention de le gouvernement je ai ordonné , conformément à le paragraphe 55 ( 1 ) de le Règlement , la publication de un Feuilleton spécial donnant avis de deux motions ministérielles .	i wish to inform the House that in accordance with the presentation made by the government , pursuant to Standing Order 55 ( 1 ) , I have caused to be published a special Order Paper giving notice of two government motions .
je dépose maintenant les documents pertinents sur le bureau .	i now lay upon the table the relevant documents .
* * *	* * *
les SERMENTS De OFFICE	oaths OF OFFICE
le trèshon. Jean Chrétien ( premier ministre , Lib . ) demande à présenter le projet de loi C - 1 , Loi concernant le administration de les serments de office .	right Hon. Jean Chr é tien ( Prime Minister , Lib . ) moved for leave to introduce Bill C - 1 respecting the administration of oaths of office .
( les motions sont adoptées et le projet de loi est lu pour la première fois . )	( motions deemed adopted and bill read the first time )
* * *	* * *
le DISCOURS DU TRÔNE	speech FROM THE THRONE
le Président :	the Speaker :
honorables sénateurs et sénatrices ,	members of the House of Commons ,
mesdames et Messieurs les députés ,	ladies and Gentlemen :
de plus , en tant que Gouverneur général , je ai visité toutes les provinces ainsi que les territoires .	as Governor General I have visited every province and territory , and I wish every Canadian could share that experience .
ce est une expérience que je souhaite à tous les Canadiens . Nos villes et nos villages reflètent la diversité de tous ceux et celles qui se sont établis dans ce pays .	our cities , towns , and villages reflect the diversity of all those who have come to this country .
pourtant , dans nos communautés , que elles soient situées sur les côtes ou dans les prairies , dans les régions boisées ou la toundra , on retrouve la même attitude amicale , le même esprit de ouverture et la même générosité .	and yet our communities , whether on the coasts or the prairies , whether in the woodlands or on the northern tundra , show the same friendliness , openness , and generosity .
les gens se entraident de diverses façons , et ils ne hésitent pas à donner temps et soutien à leur communauté .	people care for each other in many ways , and they give their time and their support to their community .
quand je suis devenu Gouverneur général , je ai déclaré que je avais le intention de souligner la générosité de les Canadiens , surtout de les bénévoles .	when I became Governor General , I stated my intention to honour the generosity of Canadians , especially as demonstrated by volunteers .
nous avons donc créé le Prix pour le entraide , qui reconnaît la générosité de les plus dévoués de entre eux .	we have now created the Caring Canadian Award to recognize the most dedicated among them .
mes fonctions me amènent à rendre visite à de nombreuses unités de les Forces canadiennes .	in my functions , I visit with many units of the Canadian Forces .
je admire le dévouement dont ces hommes et ces femmes ont fait preuve en tant que gardiens de la paix , leur héroïsme dans les missions de recherche et de sauvetage et leur promptitude à agir en cas de catastrophes naturelles , comme les inondations dans les régions de le Saguenay et de la rivière Rouge .	they have impressed me with their dedication , as demonstrated by their peacekeeping role , their heroic work in search and rescue , and their immediate response to natural disasters such as the Saguenay region and Red River floods .
que on me permette de mentionner une autre réalisation dont je tire grande fierté : la proclamation de le 21 Juin , le jour le plus long de le année , comme Journée nationale de les Autochtones en le honneur de les premiers peuples de le pays .	let me mention another source of great pride : the proclamation of the twenty - first of June , the longest day of the year , as National Aboriginal Day - a day to honour the First Peoples of this land .
une nouvelle législature ...	a New Parliament -
ce jour marque le ouverture de une nouvelle législature - la dernière de le XXe siècle et la première de le XXIe siècle - une législature qui a une occasion historique unique de exercer un leadership sur les questions de envergure nationale pour assurer le avenir de les Canadiens .	today marks the opening of a new Parliament , the last Parliament of the 20 th century and the first Parliament of the 21 st century , a Parliament with a unique and historic opportunity to provide leadership on national issues to secure the future for Canadians .
le 2 juin 1997 , les Canadiens ont renouvelé le mandat de le gouvernement .	on June 2 , 1997 , the people of Canada renewed the mandate of the Government .
À le cours de cette législature , le gouvernement remplira les engagements que il a pris auprès de les Canadiens dans sa plate - forme électorale .	over the course of this Parliament , the Government will fulfil the commitments it made to the people in its election platform .
le Parlement de le Canada est la seule institution dont les membres sont directement élus par tous les Canadiens . Il a pour mandat de protéger le intérêt national et de lui donner une forme concrète .	the Parliament of Canada is the only institution directly elected by all Canadians with the mandate to protect and express the national interest .
Élu par tous les Canadiens avec la légitimité que cela lui confère , le gouvernement de le Canada , tant à le pays que à le étranger , défendra les valeurs communes auxquelles adhèrent les Canadiens .	elected by all Canadians and endowed with the legitimacy that this bestows , the Government of Canada will stand up for the shared values of Canadians at home and abroad .
pour gouverner à le XXIe siècle , il faut accepter le fait que aucun gouvernement ne peut agir isolément .	but governing in the 21 st century also means recognizing that no one government can act alone .
Étant donné la complexité de les enjeux auxquels nous faisons face comme citoyens dans le contexte de une économie mondiale , la coopération est essentielle à notre réussite comme pays .	given the complexity of the issues that face us as citizens in a global economy , collaboration is an essential ingredient for the success of Canada .
plus que jamais , les Canadiens veulent que leurs gouvernements travaillent en partenaires .	more than ever , Canadians want their governments to work together in partnership .
À le aube de un nouveau millénaire , devant les défis et les possibilités que il nous offre , nous pouvons jeter un regard sur le dernier siècle de le histoire canadienne et affirmer sans contredit que le Canada est vu dans le monde entier , à juste titre , comme un exemple de réussite extraordinaire .	as we look forward to the beginning of a new millennium with new challenges and new opportunities , we can look back at the last century of Canadian history and state with certainty that Canada is rightly regarded , the world over , as an extraordinary success .
le Canada représente le triomphe de le esprit humain ; il rassemble le meilleur de ce que les hommes et les femmes sont capables de faire .	canada represents a triumph of the human spirit , bringing together the best of what people can do .
... vers un nouveau siècle de réalisations canadiennes	- for a New Century of Canadian Achievement
À le fur et à mesure que les vieilles contraintes que nous imposaient le temps et les distances se estompent , les individus comme les collectivités peuvent aujourd' hui accomplir de les choses autrefois impensables .	as old and familiar constraints of time and distance are breaking down , individuals and communities can accomplish things once unimaginable .
le Canada est prêt .	canada is ready .
le succès nous attend .	we are poised for success .
nos citoyens ont les qualités requises pour réussir à le XXIe siècle .	our citizens have the qualities that are needed to succeed in the 21 st century :
nous avons le sens de le partage et de le entraide .	we have the values of sharing and mutual help .
nous sommes instruits .	we are well educated .
nous sommes innovateurs et ouverts à les idées nouvelles .	we welcome innovation and new ideas .
nous sommes une société ouverte et démocratique .	we are an open and democratic society .
nous sommes un pays bilingue et multiculturel à une époque de mondialisation croissante .	we are a bilingual and multicultural country at a time of increasing globalization .
nous avons appris à composer avec nos différences et notre diversité , et à en faire de les atouts .	we have learned to accommodate our differences and diversity and turn them into strengths .
notre fédération tire le meilleur parti possible de ces talents .	our federation makes the most of these talents .
elle nous donne la cohésion nécessaire pour multiplier les atouts dont nous disposons en conjuguant nos talents , en regroupant nos ressources et en partageant les risques .	it gives us the cohesion we need to multiply our strengths by combining our talents , by pooling our resources and by sharing risks .
elle nous donne aussi la souplesse requise pour expérimenter et innover afin de assurer notre succès dans un monde en rapide évolution .	it also gives us the flexibility we need to experiment and innovate in order to succeed in a rapidly changing world .
le gouvernement tient à reconnaître le rôle important que joue une fonction publique professionnelle et non partisane dans une société civile performante .	the Government wishes to recognize the important role of a professional , non - partisan public service in a well - performing civil society .
le Canada est bien servi par sa fonction publique , ainsi que par les efforts et le dévouement que elle démontre en répondant à les besoins de les citoyens et en travaillant en partenariat avec les gouvernements et les autres secteurs de la société .	canada is served well by its public service , and the effort and dedication it exhibits in meeting the needs of citizens and in building partnerships among governments and other sectors of society .
le gouvernement poursuivra le renouvellement de la fonction publique de le Canada afin que ses membres aient les compétences et le dévouement pour continuer à bien servir les Canadiens .	the Government will continue to renew the Public Service of Canada to ensure its members have the skills and dedication to continue serving Canadians well .
nous avons déjà jeté les bases de notre succès	we Have Already Built a Foundation for Our Success
ces dernières années , les Canadiens ont fait beaucoup de efforts et de sacrifices pour surmonter un grand nombre de difficultés auxquelles notre pays a fait face .	in recent years , Canadians worked hard and sacrificed to overcome many of our nation ' s challenges .
nous y sommes parvenus , et nous avons commencé à jeter de les bases solides sur lesquelles se fondera notre réussite à le cours de le nouveau millénaire .	we succeeded , and have started to put in place a strong foundation for our success in the new millennium .
cette 36e législature se ouvre à le moment où nous avons mis de le ordre dans les finances publiques et où le économie se engage dans un cycle de croissance vigoureuse .	this 36 th Parliament opens at a time when we have brought order to our public finances , and the economy is entering a period of strong growth .
certes , le chômage est encore trop élevé , mais de les centaines de milliers de emplois nouveaux sont créés par le secteur privé , le taux de inflation est très bas et les taux de intérêt ne ont jamais été aussi faibles depuis plus de trente ans .	while unemployment is still too high , hundreds of thousands of new jobs are being created by the private sector , inflation is at very low levels , and interest rates are lower than they have been in more than three decades .
un nombre croissant de sociétés canadiennes vendent aujourd' hui plus de biens et de services dans le monde entier que jamais auparavant .	more Canadian companies are selling more goods and services to the world than ever before .
stimuler la création de emplois et la croissance économique a toujours été un objectif primordial de le gouvernement de le Canada .	stimulating job creation and economic growth has been , remains , and will continue to be a major objective of the Government of Canada .
le gouvernement se appuiera sur les progrès réalisés et sur les bases solides établies à le cours de ces quatre dernières années pour renforcer le économie et augmenter la confiance .	the Government will build on the progress achieved and the foundations put in place over the last four years to strengthen the economy and increase confidence .
nous poursuivrons dans cette voie et nous prendrons de les mesures supplémentaires pour encourager les nouveaux investissements , créer de nouveaux emplois , et générer la richesse nationale nécessaire pour assurer à les Canadiens un avenir stable et sûr .	we will pursue this course and take further action to encourage new investment , to create new jobs , and to generate the national wealth necessary to assure Canadians a stable and secure future .
le gouvernement continuera à faire preuve de vigilance et à gérer avec sagesse les finances de le pays .	the Government will continue to be vigilant and responsible about keeping the financial affairs of the country in order :
il se assurera que le ratio de la dette à le produit intérieur brut diminue de façon permanente .	it will put the debt - to - GDP ratio on a permanent downward track .
il équilibrera le budget à le plus tard durant le année financière 1998 - 1999 .	it will balance the budget no later than fiscal year 1998 - 99 .
il déposera de les projets de loi pour mettre en oeuvre les changements proposés à le Régime de pensions de le Canada de même que la nouvelle prestation à les aînés , afin que le Canada continue de avoir un régime public de pensions abordable à le XXIe siècle .	it will introduce legislation to implement the proposed changes to the Canada Pension Plan and the new Seniors Benefit in order to ensure Canada ' s public pension system remains sustainable in the 21 st century .
À le Canada , un emploi sur trois est tributaire de le commerce .	one in three Canadian jobs depend on trade .
notre prospérité et notre capacité de créer de les emplois sont liées à la manière dont nous savons exploiter les débouchés à le étranger .	our prosperity and our ability to create jobs are directly linked to how well we capitalize on international opportunities .
les missions commerciales de Équipe Canada ont ouvert une foule de possibilités nouvelles à les entreprises canadiennes , et démontré les mérites de la collaboration entre les gouvernements et le secteur privé .	team Canada trade missions have successfully generated new opportunities for Canadian businesses and have illustrated what we can accomplish when governments and the private sector collaborate .
le gouvernement se appuiera sur le succès de cette collaboration pour établir avec les milieux industriels une stratégie destinée à améliorer notre performance économique internationale , en élargissant notre base commerciale , et en faisant de le Canada un lieu privilégié pour les investisseurs de le monde entier et une destination touristique recherchée .	the Government will build on this success with a focussed strategy , developed in consultation with industry , to improve our international economic performance by expanding Canada ' s trade base , becoming the location of choice for global investment , and making Canada a preferred tourist destination .
le gouvernement de le Canada a regagné sa capacité de répondre à les priorités de les Canadiens sans excéder ses moyens financiers .	the Government has regained the ability to address priorities of Canadians while living within its means .
il est maintenant en mesure de effectuer de les investissements stratégiques pour nos enfants , nos jeunes , notre santé , nos collectivités , ainsi que pour le secteur de le savoir et de la créativité , tout en continuant à assainir la situation financière de le pays .	it is now in the position to make strategic investments in our children and our youth , our health , our communities , and our knowledge and creativity while continuing to improve the nation ' s finances .
le gouvernement est résolu à suivre cette approche équilibrée de investissement social et de gestion financière prudente , à le moment où il conduit le pays vers une santé économique renouvelée et durable , et une meilleure cohésion sociale .	the Government is committed to following this balanced approach of social investment and prudent financial management as it leads Canada toward renewed and lasting economic health and increased social cohesion .
notre fédération se trouve ainsi plus en mesure de répondre à les divers besoins de les Canadiens à travers le pays .	we are making the federation better able to serve the differing needs of Canadians across the country .
les Canadiens regagnent confiance en leur avenir et en celui de le pays .	Canadians feel better about their own future and the country ' s future .
ils le envisagent avec un optimisme nouveau .	we are looking to our future together with a new optimism .
le fait que nous ayons prouvé que notre pays est capable de se fixer de les objectifs ambitieux et de les atteindre nous incite à nous imposer de les objectifs encore plus élevés pour les années à venir .	the fact that we have demonstrated our ability as a country to set ambitious goals and achieve them gives us new confidence to set higher goals for the years ahead and succeed .
le défi de le avenir	our Challenge for the Future
le défi de le avenir consistera à veiller à ce que personne ne soit oublié dans la marche en avant de notre pays .	our challenge is to ensure that no Canadian is left behind as the country moves forward .
le avenir appartient à les sociétés dont le économie est saine , à celles qui investissent dans la connaissance , le éducation et le innovation ; à celles dont la population est en bonne santé , dont les enfants sont bien préparés à faire leur apprentissage , et à celles qui ont pour objectif de assurer une qualité de vie élevée à tous leurs citoyens .	the future belongs to societies whose economy is sound ; who invest in knowledge , education and innovation ; whose population is healthy ; whose children are well prepared to learn ; and who focus on securing a high quality of life for all citizens .
les Canadiens ont établi ces priorités pour cette nouvelle législature .	Canadians have already set these priorities for this new Parliament .
ces priorités sont celles de le gouvernement .	these are the Government ' s priorities .
pour un Canada plus fort	building a Stronger Canada
les gouvernements fédéral , provinciaux et territoriaux se doivent , à le égard de tous les Canadiens , de exercer un leadership responsable en faveur de le unité de le pays .	the federal , provincial and territorial governments owe it to all Canadians to take responsible leadership on the unity of the country .
le engagement le plus important de le gouvernement est de maintenir le unité de le Canada .	the single most important commitment of the Government is to keep Canada united .
il ne a pas de plus grand devoir ou responsabilité .	the Government of Canada can have no greater duty or responsibility .
À le seuil de le XXIe siècle , le objectif primordial de le gouvernement de le Canada est à la fois simple et ambitieux .	the overriding goal of the Government of Canada as we approach the 21 st century is both simple and ambitious .
il consiste à renforcer notre pays et à en assurer le unité en contribuant à le entreprise commune de faire en sorte que le Canada demeure un de les pays de le monde où il fait le mieux vivre .	it is to strengthen and unite this country by joining in the common purpose of keeping Canada one of the best places in the world in which to live .
pour que ces aspirations se réalisent pleinement , il faudra mobiliser les Canadiens de tous les horizons , ainsi que les institutions , les entreprises privées , les milieux bénévoles et les gouvernements .	realizing these aspirations fully will require the active engagement of Canadians in all walks of life , as well as our institutions , businesses , voluntary organizations and our governments .
il faudra de la collaboration et de les partenariats .	it will require collaboration and partnership .
il faudra se tendre la main .	it will require reaching out .
À le cours de leur réunion la semaine dernière , neuf premiers ministres provinciaux et les deux leaders territoriaux ont réaffirmé leur désir de collaborer plus étroitement avec le gouvernement de le Canada dans les domaines de les soins de santé et de la politique sociale .	in their meeting last week , nine Premiers and the two territorial leaders reiterated their desire for closer co - operation with the federal government in the areas of health care and social policy .
le gouvernement se réjouit de le intérêt continu de les premiers ministres et de les leaders territoriaux à travailler de concert , et il se engage à collaborer de encore plus près avec eux pour régler ces importantes questions .	the Government welcomes the Premiers ' and territorial leaders ' continuing interest in working together , and is committed to even closer collaboration on these important issues .
comme étape suivante , les premiers ministres se rencontreront cet automne pour travailler ensemble sur les questions de le chômage chez les jeunes , de les soins médicaux et de le renouvellement de la politique sociale .	as a next step , the First Ministers will meet this fall to work on co - operative approaches to address youth unemployment , health care and social policy renewal .
pour promouvoir et renforcer notre unité , le gouvernement adoptera une démarche ouverte et englobante .	the Government will take a very broad and encompassing approach to promoting and strengthening our unity .
toutes les grandes mesures que il prendra serviront à faire de le Canada un pays meilleur , et , de ce fait , plus uni .	all its major initiatives will serve to make Canada better and thus more united .
le gouvernement abordera son mandat dans un esprit de collaboration et de partenariat avec tous ses partenaires de la société canadienne .	the Government will approach its mandate committed to collaboration and partnership with all its partners in Canadian society .
le Canada nous offre un espace et de les moyens communs pour réaliser notre potentiel .	canada provides our common space and our common means for realizing our potential .
nous nous affaiblirions irrémédiablement et nous connaîtrions un changement irréversible , si nous cessions de maintenir le exemple que le Canada offre à le monde .	we would all be forever diminished , forever changed , should we fail to maintain the example Canada provides to the world .
le avenir de notre pays nous est trop précieux pour que nous risquions de le compromettre à cause de malentendus .	our future as a country is too precious for us to risk losing it through misunderstanding .
ce est pourquoi le gouvernement se assurera que tout débat visant à remettre en question le existence même de le Canada ou son unité soit franc et transparent .	therefore , the Government will bring frankness and clarity to any debate that puts into question the future existence or unity of Canada .
il se emploiera à mieux faire comprendre la complexité de tout projet de rupture et les difficultés véritables qui nous attendent si nous brisons les liens que nous avons tissés en édifiant ensemble notre nation .	it will create a better understanding of the true complexity and difficulty for all of us in severing ties that have developed in building a nation together .
et surtout , il montrera que nous pourrons accomplir beaucoup plus en demeurant ensemble que en rompant ces liens .	most of all , it will demonstrate how much more we can do together than apart .
le gouvernement travaillera de près avec les gouvernements provinciaux et territoriaux à bâtir sur ce que ont accompli les neuf premiers ministres et les leaders territoriaux la semaine dernière à Calgary , dans le but de en arriver à la pleine reconnaissance de la diversité propre à la fédération , y inclus de le caractère unique de la société québécoise .	the Government will work closely with provincial and territorial governments to further advance the progress made by nine Premiers and the territorial leaders last week in Calgary toward the full recognition of the diversity inherent in the federation , including the unique character of Quebec society .
nous nous inspirerons de le respect mutuel qui existe entre les Canadiens pour créer le avenir meilleur auquel nous aspirons tous .	we will build on the mutual respect Canadians have for one another to achieve our common aspirations for a better future .
investir dans nos enfants	investing in Children
un pays qui a décidé de investir dans ses enfants est un pays qui a foi en le avenir .	a country that has decided to invest in its children is a country that is confident in its future .
et un pays qui investit dans ses enfants aura un avenir meilleur .	a country that invests in its children successfully will have a better future .
un de nos objectifs en tant que pays devrait être de nous assurer que tout est mis en oeuvre pour permettre à tous les enfants de le Canada de réaliser leur potentiel .	one of our objectives as a country should be to ensure that all Canadian children have the best possible opportunity to develop their full potential .
nous devons tous faire en sorte que nos enfants soient capables de apprendre et de participer pleinement à la vie de la société .	we must equip our children with the capacities they need to be ready to learn and to participate fully in our society .
certes , ce sont les familles qui sont responsables , à le premier chef , de élever leurs enfants et de favoriser leur développement .	while families have the greatest responsibility in the nurturing and development of our children , they are not alone .
cela exige que le on mette le accent sur ce dont ils ont besoin pour se épanouir .	it requires focussing on what children need to thrive .
les expériences que vivent nos enfants , en particulier lorsque ils sont encore tout jeunes , ont une influence sur leur santé , sur leur bien - être , ainsi que sur leur capacité de apprentissage et de adaptation pendant toute leur vie .	the experiences of Canada ' s children , especially in the early years , influence their health , their well - being , and their ability to learn and adapt throughout their entire lives .
en investissant dès maintenant dans le bien - être de les enfants , nous améliorerons la santé à long terme de notre société .	by investing now in the well - being of today ' s children , we improve the long - term health of our society .
une de les priorités de le gouvernement est de répondre à les besoins de les familles à faible revenu qui ont de les enfants .	addressing the needs of low - income families with children is therefore a priority of the Government .
les gouvernements fédéral , provinciaux et territoriaux sont convenus de coopérer à la recherche de solutions à les problèmes de les familles à faible revenu ayant de les enfants .	federal , provincial and territorial governments have agreed to address in a co - operative way the problems of low - income families with children .
de concert , nous édifions maintenant un régime de prestation nationale pour enfants complet et efficace .	together we are now building the comprehensive and effective National Child Benefit System .
le gouvernement a déjà donné la preuve de son souci de réaliser ce projet en accroissant de 850 millions de dollars par an sa contribution à la prestation fiscale pour enfants , et les paiements majorés à les familles commenceront le 1 er juillet 1998 .	the Government has already demonstrated its initial commitment to this project by increasing its contribution to the Canada Child Tax Benefit by $ 850 million a year , with higher payments to families beginning July 1 , 1998 .
le gouvernement se emploiera avec ses partenaires provinciaux et territoriaux à établir un calendrier commun pour augmenter la contribution fédérale à la prestation fiscale pour enfants de à le moins 850 millions de dollars supplémentaires à le cours de ce mandat .	the Government will work with its provincial and territorial partners to establish jointly a common timetable for increasing the federal contribution to the Canada Child Tax Benefit by at least an additional $ 850 million during the course of this mandate .
le gouvernement travaillera également avec les provinces et les territoires à la création de un cadre national de réinvestissement qui guidera la réaffectation de les épargnes de nos partenaires à de nouveaux services et prestations à le intention de les familles à faible revenu ayant de les enfants .	the Government will also work with the provinces and territories to establish the National Re - Investment Framework to guide the re - allocation of our partners ' savings into new services and benefits for low - income families with children .
nous avons les moyens de améliorer la vie de nos enfants .	we can make a difference in the lives of all our children .
pour se épanouir et demeurer en santé , ceux - ci ont besoin que on leur consacre temps et attention ; ils ont aussi besoin de familles épanouies , de collectivités qui leur apportent soutien et sécurité .	children need a substantial investment of time and attention for healthy development ; they need strong families ; they need safe , supportive communities .
en janvier 1997 , les gouvernements fédéral , provinciaux et territoriaux ont convenu de élaborer ensemble le Programme national de le enfance , une stratégie complète destinée à améliorer le bien - être de nos enfants .	the federal , provincial and territorial governments agreed in January 1997 to work together to develop the National Children ' s Agenda , a comprehensive strategy to improve the well - being of Canada ' s children .
les gouvernements fédéral , provinciaux et territoriaux uniront leurs efforts pour élaborer ce programme élargi à le intention de les enfants , en établissant notamment de les indicateurs permettant de en juger le succès .	federal , provincial and territorial governments will work together to develop this broader agenda for children , including clear outcome measures by which to gauge success .
dans le cadre de ce programme national , le gouvernement de le Canada mettra en oeuvre trois initiatives nouvelles :	as part of this national agenda , the federal government will undertake three new initiatives :
il établira de les centres de excellence destinés à approfondir notre compréhension de le développement et de le bien - être de les enfants , et à améliorer notre capacité de répondre à leurs besoins .	it will establish Centres of Excellence to deepen our understanding of children ' s development and well - being and to improve our ability to respond to their needs .
il étendra à les réserves le programme Bon départ à le intention de les Autochtones , afin de permettre à tous les enfants autochtones de partir de le bon pied dans la vie .	it will expand our Aboriginal Head Start program onto reserves to ensure that all Aboriginal children have the opportunity to get a good start in life .
il mesurera la maturité scolaire de nos enfants et fera de les rapports périodiques qui permettront de évaluer les progrès accomplis pour leur donner les meilleures chances de départ dans la vie .	it will measure and report regularly on the readiness of Canadian children to learn , so that we can assess our progress in providing our children with the best possible start .
investir dans le domaine de la santé et de les soins de qualité	investing in Quality Care and Good Health
pourtant , les Canadiens sont de plus en plus inquiets face à la situation actuelle et à le avenir de leur régime de soins de santé .	nonetheless , there is an increasing anxiety among Canadians about the present state and the future of our medicare system .
ils se demandent se ils continueront à avoir accès à les meilleurs soins possible lorsque ils en auront besoin .	citizens worry about whether they will have access to the highest possible quality of health care when they need it .
cette inquiétude a de les causes multiples , notamment la rapidité et le ampleur de la restructuration entreprise depuis quelques années .	the anxiety arises from a number of sources , including the pace and extent of restructuring that has gone on in recent years .
le gouvernement de le Canada reconnaît que cette restructuration a été difficile pour les Canadiens . Il a donc décidé de accroître son aide financière à les provinces par rapport à les niveaux budgétés .	the federal government recognizes that this restructuring has been difficult for Canadians and , therefore , it will increase health care funding to the provinces from previously budgeted levels .
il déposera un projet de loi portant à 12,5 milliards de dollars les paiements en espèces annuels garantis , à les provinces et à les territoires , dans le cadre de le Transfert canadien en matière de santé et de programmes sociaux .	it will introduce legislation to increase to $ 12.5 billion a year the guaranteed annual cash payments to provinces and territories under the Canada Health and Social Transfer .
un de les objectifs de notre pays doit être de continuer à assurer à tous les citoyens le accès à les meilleurs soins de santé possible et de mettre à leur disposition les outils nécessaires pour jouir de une bonne santé à le seuil de le XXIe siècle .	one of our goals as a country must be to continue providing all our citizens with access to the highest possible quality of health care and the other tools they will need to enjoy healthy lives as we move into the 21 st century .
les Canadiens ont le droit de attendre de leurs gouvernements que ils collaborent dans le harmonie afin de mieux atteindre les objectifs communs de les Canadiens et de satisfaire leur désir de disposer de un meilleur régime de santé .	Canadians have a right to expect their governments to work together in harmony to better meet the shared goals and desires of Canadians for a better health system .
le gouvernement est fermement résolu à maintenir un système de soins de santé complet et administré par le secteur public , qui assurera à les Canadiens de toutes les régions de le pays un accès universel à de les soins de haute qualité .	the Government is firmly committed to a publicly administered , comprehensive health care system that provides universal access to high quality care for Canadians anywhere in the country .
le gouvernement a un rôle de premier plan à jouer pour protéger et renforcer le assurance - maladie .	the Government has a leadership role in preserving and enhancing medicare .
il a également un rôle constructif à jouer avec les provinces et les autres parties intéressées .	it has a constructive role to play as a partner with provinces and other interested parties .
il assumera ce rôle dans un esprit de ouverture , de pragmatisme et de innovation .	the Government will play that role in a spirit of openness , pragmatism and innovation .
nous pouvons prendre de les mesures pour guider les efforts de tous les gouvernements , et nous le ferons .	there are steps that we can and will take to lead the efforts by all governments .
préparer le Canada en vue de le XXIe siècle suppose notamment de nous assurer que le régime de assurance - maladie est adapté à les besoins de le avenir .	preparing Canada for the 21 st century means ensuring the medicare system meets the needs of the future .
cela veut dire répondre à les défis nouveaux .	it means responding to emerging issues in health care .
en collaboration avec ses partenaires , le gouvernement prendra les mesures suivantes :	working with its partners , the Government will undertake the following initiatives :
il appuiera les Canadiens dans leurs efforts pour répondre à les besoins croissants de soins à domicile et de soins communautaires .	it will take measures to support Canadians in responding to the expanding needs for home care and community care .
il établira un plan national , un calendrier et un cadre financier afin de assurer à la population canadienne un meilleur accès à les médicaments indispensables .	it will develop a national plan , timetable and a fiscal framework for providing Canadians with better access to medically necessary drugs .
il améliorera la qualité et le efficacité de les services de santé partout à le Canada en établissant le Fonds de transition pour les sciences de la santé afin de aider les gouvernements provinciaux à innover dans le domaine de les soins primaires , et à intégrer davantage la prestation de les services de santé et de les soins à domicile et le assurance - médicaments .	it will improve the quality and effectiveness of health services across Canada by establishing the Health Transition Fund to help the provincial governments innovate in the areas of primary care and provide more integration in the delivery of health services , home care and pharmacare .
les Canadiens reconnaissent que leur santé dépend de beaucoup plus que de les soins médicaux .	Canadians recognize that good health depends on much more than medical care .
la situation sociale et économique contribue également à déterminer la qualité de la santé .	our social and economic situations also help to determine the quality of our health .
nous devons , en tant que pays , intensifier nos efforts pour promouvoir de les modes de vie sains .	as a country , we must increase our efforts to promote healthy lives .
le gouvernement oeuvrera dans ce sens par le truchement de un programme destiné à promouvoir la santé .	the Government will contribute to this goal with an agenda to promote good health .
on mettra également le accent sur les facteurs qui déterminent la santé de la population de un pays , dont le égalité de les chances économiques et sociales offertes à tous les citoyens .	emphasis will also be placed on those factors that determine the health of a country ' s population , including the equality of economic and social opportunity for all citizens .
certains de les problèmes de santé les plus pressants se trouvent actuellement dans les collectivités autochtones .	some of the most urgent health problems today are found in Aboriginal communities .
le gouvernement travaillera de concert avec de autres partenaires et avec les collectivités autochtones :	the Government will work with other partners and Aboriginal communities to
à élaborer de nouvelles initiatives pour faire face à le augmentation rapide de les cas de tuberculose et de diabète dans les communautés autochtones ;	develop new initiatives to address the rapid increase in tuberculosis and diabetes in Aboriginal communities ; and
à accroître la recherche et la diffusion de renseignements sur la santé axés sur les besoins de les peuples autochtones , grâce à la création de un institut sur la santé de les Autochtones .	enhance research and dissemination of health information focussed on the needs of Aboriginal people through a new Aboriginal Health Institute .
le gouvernement collaborera avec ses partenaires provinciaux et avec de autres parties intéressées à le amélioration de les systèmes canadiens de information sur la santé en vue de rendre plus efficaces les décisions touchant la santé et les soins partout à le Canada .	the Government will work with its provincial partners and other interested parties to improve Canadian health information systems to improve decision making about health and health care across the country .
vivre en sécurité dans nos collectivités	building Safer Communities
une de les marques distinctives de le identité canadienne est le fait que nous vivons en sécurité dans nos collectivités .	safe communities are among the hallmarks of our Canadian identity .
même si le taux de criminalité rapporté a diminué à le cours de les quatre dernières années , il est encore trop élevé .	while the reported crime rate has decreased for four consecutive years , it is still too high .
le gouvernement se engage à faire en sorte que le Canada soit un endroit où les Canadiens se sentent en sécurité chez eux et dans la rue .	the Government is committed to ensuring that Canada remains a place where Canadians feel secure in their homes and on the streets of their communities .
vivre en toute sécurité suppose une solide prévention de le crime et le utilisation de les moyens juridiques conventionnels .	a safe society depends on strong crime prevention efforts as well as traditional legal responses .
les gouvernements de le monde entier sont en train de mettre à le point de les programmes communautaires de prévention .	governments around the world are developing community - based crime prevention programs .
il augmentera à 30 millions de dollars par année le financement de les mesures communautaires de prévention de le crime .	increase funding for community - based crime - prevention initiatives to $ 30 million per year ;
il élaborera de les solutions de rechange à le incarcération de les contrevenants non violents à risque peu élevé , telles que de les réformes à les modes de détermination de les peines et de les programmes communautaires de déjudiciarisation , et de autres formes de sanctions .	develop alternatives to incarceration for low - risk , non - violent offenders , such as sentencing reforms , community diversion programs , and alternative sanctions ; and
il intégrera les systèmes de diffusion de le information de tous les partenaires de le appareil de justice pénale .	integrate information systems of all partners in the criminal justice system .
offrir de les possibilités à les jeunes Canadiens	creating Opportunity for Young Canadians
la génération actuelle de jeunes Canadiens est la plus instruite de notre histoire .	today ' s generation of young Canadians is the best educated in our history .
ils vivent dans un pays bien placé pour profiter de les possibilités que offre la nouvelle économie .	young Canadians are living in a country well - positioned for opportunities in the new economy .
pourtant , le niveau de chômage de les Canadiens de 18 à 25 ans est inacceptable .	yet , the level of unemployment among Canadians between the ages of 18 and 25 is unacceptably high .
les gouvernements fédéral , provinciaux et territoriaux agiront face à ce problème , et les premiers ministres et les leaders territoriaux se y attaqueront à leur réunion de le automne .	the federal , provincial and territorial governments will act to address this problem , and First Ministers and territorial leaders will be working on this issue when they meet this fall .
pour préserver le avenir de notre société , notre défi immédiat est de assurer une insertion réussie de les jeunes dans le monde de le travail , de faire en sorte que les jeunes qui veulent continuer à apprendre aient accès à le éducation , et que une seconde chance soit offerte à ceux qui ont trouvé difficile de se faire une place dans le monde de le travail .	to secure our future as a society , our immediate challenge is to make sure that our young generation makes a successful transition to the world of work , that young people who want to continue to learn have access to education , and that young people who found it difficult getting started in the workplace get a second chance .
il est dans le intérêt de tous les Canadiens que ce défi soit relevé avec succès .	all Canadians have a stake in meeting this challenge successfully .
aucun secteur de la société , aucun gouvernement ne possède toutes les solutions .	no single sector of society nor any one level of government has all the answers .
il faut que nous travaillions de concert , chacun dans son domaine de compétence , pour relever le défi que nous nous sommes fixé .	we must all contribute , each in our areas of competency , to meet the challenge we have set for ourselves .
le gouvernement se réjouit de le fait que le secteur privé ait pris de les mesures telles que Avantage Carrière et la création de un conseil de entreprises sur la place de les jeunes dans le économie ; il le encourage à continuer dans ce sens .	the Government welcomes the action being taken by the private sector , through initiatives such as Career Edge and the Corporate Council on Youth in the Economy , and encourages the private sector to do more .
le gouvernement est résolu à travailler avec les autres gouvernements , le secteur privé , les collectivités et les citoyens pour fournir à les jeunes les outils pour faire face à le avenir .	the Government is committed to work with other governments , the private sector , communities and individual Canadians to help equip young people for the future .
assurer le plus grand accès possible à le éducation postsecondaire est un rôle important pour tous les gouvernements .	an important role for governments is to ensure the widest possible access to post - secondary education .
les Canadiens se inquiètent de le augmentation de le coût de le enseignement supérieur et de les dettes que cela impose à les étudiants .	Canadians are concerned about the increasing cost of higher education , and the resulting debt burden on students .
dans son budget de février 1997 , le gouvernement a pris de les mesures importantes pour faire face à ce problème .	the Government took some important measures to address this problem in its budget of February 1997 .
il continuera de réduire les obstacles à le éducation postsecondaire en apportant de autres modifications à le Programme canadien de prêts à les étudiants , en augmentant le aide à les étudiants ayant de les personnes à charge , et en créant de les bourses qui encourageront le excellence et aideront les Canadiens à revenu faible ou modeste à fréquenter le collège ou le université .	the Government will continue to reduce barriers to post - secondary education through further changes to the Canada Student Loans Program , increased assistance for students with dependents , and new scholarships to encourage excellence and to help low - and moderate - income Canadians attend university or college .
le gouvernement trouve inacceptable que de les milliers de emplois demeurent vacants dans les secteurs à croissance élevée de notre économie , alors même que de les jeunes Canadiens sont à le chômage .	the Government finds it unacceptable that thousands of jobs are going unfilled in high - growth sectors of our economy at the same time as young Canadians are unemployed .
le gouvernement collaborera avec les provinces , les universités et les collèges , le secteur de la haute technologie et les autres secteurs en croissance rapide pour établir de meilleures prévisions de le nombre et de les types de emplois disponibles , et pour élaborer un plan assurant que les Canadiens soient éduqués adéquatement pour combler ces postes .	the Government will work with the provinces , universities and colleges , the high - tech industry and other rapidly growing sectors to better forecast the number and types of jobs that will be available and to develop a plan for ensuring that people are appropriately educated to fill them .
trois facteurs jouent un rôle important pour le insertion dans le monde de le travail - un bon niveau de instruction , la possibilité de trouver un premier emploi , et la présence de mentors qui aident les jeunes à se établir .	three factors make a significant difference to young people getting started in the world of work - a good education , a chance at a first job , and a mentor to work with as they establish themselves .
le gouvernement consacrera plus de ressources à le aide à les jeunes afin de faciliter leur insertion dans le monde de le travail et de la rendre productive .	the Government will increase its resources devoted to helping youth to make a smooth and productive entry into the world of work .
les programmes de stage , en particulier , ont donné de excellents résultats dans ce domaine .	internship programs have been particularly successful in helping young people get started .
un programme pancanadien de mentorat sera créé en partenariat avec les gouvernements provinciaux et le secteur privé .	in partnership with provincial governments and the private sector , a Canada - wide mentorship program will be developed .
pour aider les jeunes Canadiens qui ont besoin de prendre un second départ , le gouvernement élaborera et étoffera les programmes communautaires destinés à les jeunes qui ont le plus de difficultés à se tailler une place dans le monde de le travail , à cause de leur peu de instruction et de compétences .	to help those young Canadians who need a second chance , the Government will develop and expand community - based programs for youth with the greatest difficulty making the transition to the world of work because of low education and skills .
ces centres apporteront une aide socioculturelle ciblée , et ils fourniront plus de possibilités de emploi et de apprentissage à les jeunes Autochtones vivant en milieu urbain .	these will include establishing multi - purpose Aboriginal youth centres that will provide targeted social and cultural support in addition to increasing work and learning opportunities for urban Aboriginal youth .
le gouvernement continuera à soutenir les efforts de les particuliers , de les collectivités et de les autres gouvernements pour accroître la capacité de apprentissage permanent de les Canadiens .	the Government will continue to support efforts of individuals , communities and other governments to improve Canadians ' capacity to learn throughout their lives .
investir dans le savoir et la créativité	investing in Knowledge and Creativity
la révolution dans les domaines de le savoir et de le information transforme tous les secteurs de le économie , depuis celui de les ressources jusque à celui de les services .	the revolution in the knowledge and information economy is transforming all sectors of the economy from primary resources to service industries .
le Canada est bien placé pour se imposer comme chef de file à le sein de le économie mondiale de le XXIe siècle , qui sera axée sur les connaissances .	canada is well - positioned to be a world leader in the global knowledge - based economy of the 21 st century .
il possède les talents , les ressources , la technologie et les institutions nécessaires .	we have the talent , we have the resources , we have the technology , and we have the institutions .
si nous réussissons à mobiliser nos ressources , nos citoyens seront en mesure de se tailler une place dans le économie mondiale fondée sur le savoir .	by rising to the challenge of mobilizing our resources well , we can enable our citizens to succeed in the global knowledge - based economy .
nous stimulerons ainsi la création constante de emplois et la croissance soutenue de notre niveau de vie à le XXIe siècle .	this is how we will spur continuing job creation and sustained growth in our standard of living in the 21 st century .
le gouvernement est résolu à faire plus pour soutenir ceux qui innovent et prennent de les risques , et pour attirer plus de investissements étrangers à le Canada dans les industries fondées sur le savoir .	the Government is determined to do more to support innovation and risk - taking in Canada and to attract more foreign investment in knowledge - based industries to Canada .
nous formerons de les partenariats créateurs entre le secteur privé et le secteur public afin de accélérer le adoption de technologies innovatrices dans tous les domaines .	we will build creative partnerships between the private and public sectors to accelerate the adoption of innovative technologies in all sectors of the economy .
en particulier , le gouvernement accroîtra sensiblement les ressources destinées à aider les petites et moyennes entreprises à développer et à commercialiser de nouvelles technologies .	in particular , the Government will significantly increase the resources allocated to help small and medium - size businesses develop and commercialize new technology .
le gouvernement explorera de les politiques et de les mesures innovatrices destinées à élargir les possibilités de les Canadiens de les communautés rurales .	the Government will explore innovative policies and measures that give particular attention to increasing opportunity for Canadians in rural communities .
il adaptera ses programmes afin de refléter les réalités socio - économiques de les milieux ruraux de le Canada .	it will adapt its programs to reflect the social and economic realities of rural Canada .
il redoublera de efforts afin que les communautés rurales et toutes les régions de le Canada profitent de les avantages de le économie mondiale fondée sur le savoir .	further , the Government will redouble its efforts to ensure that rural communities and all regions of Canada share in the economic benefits of the global knowledge - based economy .
les gouvernements ont un rôle capital à jouer pour appuyer la science , la technologie et la création de le savoir .	governments have a crucial role to play in supporting science , technology , and the creation of knowledge .
la dotation par le gouvernement de le Canada de la Fondation canadienne pour le innovation , en partenariat avec le secteur privé , les provinces et les universités , contribue à la mise sur pied de un système national de innovation de pointe .	the Government of Canada ' s endowment of the Canada Foundation for Innovation in partnership with the private sector , the provinces and universities , is helping to build a leading - edge national system of innovation .
tous les gouvernements doivent accroître leur aide à la recherche effectuée dans les universités .	all levels of government must do more to provide public support for research done in our universities .
le appui à le savoir va au - delà de le aide à la recherche universitaire .	support for knowledge goes beyond support for university research .
en soutenant davantage les arts , on permet à la culture canadienne de atteindre de les publics à le pays et à le étranger .	increasing support for the arts makes it possible for Canadian culture to reach audiences at home and abroad .
nos films , nos livres , nos périodiques , nos pièces de théâtre , nos vidéos , notre musique et nos productions multimédias nous parlent de nous en même temps que ils font connaître la créativité canadienne dans le monde .	our movies , books , magazines , plays , videos , music , and multi - media productions speak to us about our experiences at the same time as they present Canadian creativity to the world .
par conséquent , le gouvernement de le Canada accroîtra son soutien à le Conseil de les Arts , et il se emploiera particulièrement à aider la culture à le pays et à promouvoir le commerce de les produits et services culturels et éducatifs canadiens à le étranger .	therefore , the Government of Canada will provide increased support to the Canada Council and will make special efforts to support culture at home and to promote trade in Canadian cultural and educational products and services abroad .
nous mettrons le infrastructure de le information et de le savoir à la portée de tous les Canadiens de ici le an 2000 , ce qui fera de le Canada le pays le plus « branché » de le monde .	we will make the information and knowledge infrastructure accessible to all Canadians by the year 2000 , thereby making Canada the most connected nation in the world .
les citoyens , les écoles , les bibliothèques , les petites et grandes entreprises , les collectivités rurales et autochtones , les institutions publiques et tous les paliers de gouvernement auront ainsi de nouvelles occasions de apprendre , de communiquer entre eux , de faire de les affaires et de développer leur vie sociale et économique .	this will provide individuals , schools , libraries , small and large businesses , rural and Aboriginal communities , public institutions , and all levels of government with new opportunities for learning , interacting , transacting business and developing their social and economic potential .
par exemple , nous augmenterons la capacité de les milieux bénévoles à engager de les Canadiens en leur facilitant le accès à les moyens techniques nécessaires pour que ils jouent un rôle plus important dans la société canadienne .	for example , we will enhance the voluntary sector ' s capacity to engage Canadians by improving their access to the technology they need to play a stronger role in Canadian life .
un pays « branché » , ce est beaucoup plus que un réseau de fils , de câbles et de ordinateurs .	a connected nation is more than wires , cables and computers .
ce est un pays où les citoyens ont accès à les compétences et à les connaissances dont ils ont besoin pour profiter de le infrastructure de le savoir et de le information qui évolue si rapidement .	it is a nation in which citizens have access to the skills and knowledge they need to benefit from Canada ' s rapidly changing knowledge and information infrastructure .
ce est aussi un pays dont les citoyens sont reliés les uns à les autres .	it is also a nation whose people are connected to each other .
le gouvernement continuera , de concert avec les provinces , à donner une plus grande mobilité à les personnes handicapées et à assurer leur intégration dans la vie sociale et économique de le pays .	the Government will continue to work with provinces to ensure greater mobility for people with disabilities and to ensure their integration into the economic and social mainstream of Canadian life .
le gouvernement mettra aussi de le avant de les mesures pour renforcer les réseaux reliant les Canadiens entre eux et pour accroître la connaissance de notre pays et la compréhension entre Canadiens ; ces mesures incluront le renforcement de les programmes de échanges de jeunes Canadiens .	the Government will also bring forward measures to strengthen networks among Canadians and to increase knowledge of Canada and understanding among Canadians ; these measures will include enhanced exchange programs for young Canadians .
accroître les possibilités offertes à les communautés autochtones	expanding Opportunities in Aboriginal Communities
il y a de les milliers de années , les peuples autochtones ont commencé à fonder les premières collectivités de le Canada .	thousands of years ago , Aboriginal people began building Canada ' s first communities .
aujourd' hui , en renforçant nos communautés autochtones , nous renforçons la diversité qui fait de le Canada un pays unique à le monde .	today , by strengthening our Aboriginal communities , we are reinforcing the diversity that makes Canada unique in the world .
le gouvernement va :	the Government will
développer avec les peuples autochtones de les rapports fondés sur les principes de le partenariat , de la transparence , de la prévisibilité et de la responsabilité ;	develop relationships with Aboriginal people based on the principles of partnership , transparency , predictability and accountability ;
appuyer le édification de communautés autochtones fortes , qui donneront à leurs membres de meilleures conditions de vie et de meilleures possibilités ;	support the building of strong Aboriginal communities - communities that provide their members with better living standards and opportunities ; and
renforcer la capacité de les communautés autochtones de bien se gouverner .	strengthen the capacity for good government in Aboriginal communities .
À ces fins , le gouvernement se est engagé à répondre aussitôt que possible à le rapport de la Commission royale sur les peuples autochtones .	to contribute , the Government of Canada is committed to respond to the Report of the Royal Commission on Aboriginal Peoples as soon as possible .
regard vers le extérieur	looking Outward
ce est là le héritage de le ancien premier ministre Lester B . Pearson , lauréat de le prix Nobel , dont on aurait célébré le centenaire cette année .	this tradition is the legacy of Nobel laureate and former prime minister of Canada , Lester Pearson , whose 100 th birthday we mark this year .
les Canadiens veulent que leur gouvernement transmette ce legs et lui donne un souffle nouveau à le moment où le monde se apprête à entrer dans le prochain siècle .	Canadians want their government to carry on this tradition and give it new relevance as the world enters a new century .
rien ne illustre mieux notre fidélité à ce legs que le rôle de chef de file joué par le Canada depuis 1994 dans la croisade internationale contre les mines antipersonnel .	nothing better illustrates the ongoing commitment to this tradition than Canada ' s leadership since 1994 in the international effort to ban anti - personnel mines .
cette initiative canadienne , audacieuse à le origine , a débouché sur un large consensus international qui se amplifie et qui aboutira à la signature de un traité international à Ottawa , en décembre prochain .	this Canadian initiative has evolved from a bold idea to be the focus of a large and growing international consensus that will culminate in the signing of an international treaty in Ottawa in December of this year .
le patrimoine naturel riche et diversifié de notre pays est une source de fierté nationale et un objet de admiration à le échelle internationale .	canada ' s rich and diverse natural heritage is also a source of national pride and international acclaim .
la population canadienne est à la fois la bénéficiaire et la gardienne de un pays qui recèle 9p. 100 de le eau douce de la terre , 10p. 100 de ses forêts et 25p. 100 de ses terres humides .	Canadians are both the beneficiaries and the stewards of a land that holds 9 % of the Earth ' s fresh water , 10 % of its forests , and 25 % of its wetlands .
nous tirons grand plaisir de notre magnifique environnement , mais nous nous inquiétons de son avenir .	Canadians both delight in our magnificent environment and fear for its future .
entretenir ce qui est en bon état et améliorer ce qui a été détérioré exige un effort constant .	maintaining what is good , and improving what has been degraded , requires constant effort .
le gouvernement fera cet effort .	it is an effort that the Government will make .
le gouvernement se est engagé à travailler sur la scène internationale pour promouvoir le développement durable et pour trouver de les solutions pratiques à les problèmes de environnement mondiaux comme le émission de les gaz à effet de serre et les produits chimiques toxiques .	the Government is committed to working in the international community to promote sustainable development and to achieve practical solutions to global environmental problems , such as greenhouse gas emissions and toxic chemicals .
il continuera de traiter le problème international sérieux de la surpêche .	it will also continue to address the serious international problem of over - fishing .
il est résolu à prendre de les mesures nationales pour réduire la part de le Canada dans ces problèmes .	it is committed to acting at home to reduce our contribution to these problems .
dans le même esprit de internationalisme propre à le Canada , le gouvernement prendra les mesures suivantes :	in this same Canadian tradition of internationalism , the Government will undertake the following initiatives :
il fera la promotion de les valeurs canadiennes sur la scène mondiale en coopérant avec les pays qui partagent ses vues afin de revivifier les Nations Unies et de autres grandes institutions multilatérales .	it will promote Canadian values on the world stage by co - operating with like - minded countries to revitalize the United Nations and other key multilateral institutions .
il travaillera directement avec de autres pays pour mettre en valeur et promouvoir les droits de la personne , le édification de la paix et la démocratie .	it will work directly with other countries to enhance and promote human rights , peace building and democracy .
il détruira les stocks de mines antipersonnel de le ministère de la Défense nationale préalablement à la signature de le traité de Ottawa , en décembre , pour poursuivre son oeuvre de chef de file et manifester son engagement en faveur de une interdiction mondiale .	it will destroy the Department of National Defence ' s stock of land mines , in advance of the signing of the Ottawa Treaty in December , to continue its leadership and illustrate its commitment to a global ban .
et le Canada continuera de militer pour le adoption de une stratégie internationale connexe destinée à aider les victimes de mines antipersonnel à se rétablir et les populations civiles à déminer et reconquérir leurs terres .	and Canada will continue to work toward an accompanying international strategy to help land mine victims recover and civilian populations reclaim their land from these mines .
il poursuivra son travail de réforme de les forces armées canadiennes .	it will continue to move forward with reforms to the Canadian military .
il poursuivra sa campagne de libéralisation de le commerce .	it will continue its campaign for liberalized trade .
le élimination de les barrières commerciales à le Canada même et ailleurs dans le monde ouvre de les marchés pour les biens et services canadiens et est la meilleure occasion de accroître notre prospérité .	breaking down trade barriers , both within Canada and around the world , helps ensure markets for Canadian goods and services and provides the best opportunity for greater prosperity .
célébration de le nouveau millénaire	celebrating the Millennium
le début de le nouveau millénaire donnera à les Canadiens une occasion historique de célébrer leurs réalisations et de souligner leurs espoirs pour le avenir .	for Canadians , the start of the new millennium represents an historic opportunity to celebrate our achievements as a nation and our hopes for the future .
ce sera une occasion sans égale de montrer à nous - mêmes et à le reste de le monde la richesse de notre diversité , la force de les valeurs canadiennes et le avenir prometteur que nous réserve le xxie siècle .	it will be an unequalled opportunity to show ourselves and the world the richness of our diversity , the strength of Canadian values , and the great promise of our future in the 21 st century .
le gouvernement aidera à former de les partenariats entre les gouvernements , les collectivités et les citoyens en vue de célébrer le nouveau millénaire .	the Government will help build a partnership among governments , communities and citizens to mark the new millennium .
de nombreux Canadiens ont de les idées et de les suggestions originales de projets de le millénaire .	many Canadians have creative ideas and suggestions for millennium projects .
les parlementaires de tous les partis se verront offrir le occasion de suggérer de les activités pour souligner le nouveau millénaire .	there will also be an opportunity for parliamentarians from all parties to participate in developing ideas to mark the millennium .
sur la voie de le XXIe siècle	moving Forward into the 21 st Century
il y a près de cent ans , sir Wilfrid Laurier déclarait que le XXe siècle serait celui de le Canada et de son développement .	almost 100 years ago , Sir Wilfrid Laurier said , " The 20 th century shall be the century of Canada and of Canadian development . "
il avait raison .	he was right .
aujourd' hui , nous avons la chance de atteindre à le XXIe siècle un succès qui dépassera largement ce que Laurier aurait jamais pu imaginer .	today , we have the opportunity for success in the 21 st century that is far beyond what Laurier could have ever imagined .
pour y arriver , il y a encore de le travail à faire - travail que personne ne peut faire seul .	to achieve this success we have more work to do - work that no one can do alone .
nous devons tous assumer la responsabilité de notre collectivité et de notre pays .	each and every one of us must assume personal responsibility for our community and our country .
notre plus grande responsabilité consiste à forger un nouvel esprit de partage et de respect mutuel en vue de le prochain siècle .	our greatest responsibility is to build a new spirit of sharing and mutual respect for a new century .
en travaillant ensemble , en respectant le atout que est notre diversité , nous garantirons notre avenir et nous bâtirons un pays plus fort .	by working together , by respecting the value of our diversity , we will secure our future and build a stronger country .
nous nous assurerons que les perspectives économiques soient solides , nos enfants bien préparés , nos vies saines et nos communautés fortes .	we will ensure that our future economic opportunities are sound , our children well prepared , our lives healthy , and our communities strong .
chaque génération peut choisir le genre de société que elle veut laisser à ses enfants .	each generation has the opportunity to choose the society it wants to leave for its children .
À le aube de le nouveau millénaire , le meilleur héritage que nous puissions léguer sera un souffle dynamique qui fera de le Canada un endroit meilleur , un pays plus fort , à le avenir prometteur et riche de promesses pour sa jeunesse .	the greatest legacy we can leave to our children in the new millennium is a vibrant living legacy that will make Canada a better place : a stronger country with a brighter future and greater opportunities for its young people .
en travaillant tous ensemble , nous y parviendrons .	by working together , we will build that future .
mesdames et Messieurs les députés ,	members of the House of Commons :
vous serez appelés à voter les crédits nécessaires pour financer les services et les dépenses approuvés par le Parlement .	you will be asked to appropriate the funds required to carry out the services and expenditures authorized by Parliament .
honorables sénateurs et sénatrices , Mesdames et Messieurs les députés ,	honourable Members of the Senate / Members of the House of Commons :
puisse la divine Providence vous guider dans vos délibérations .	may Divine Providence guide you in your deliberations .
le trèshon. Jean Chrétien ( premier ministre , Lib . ) propose :	right Hon. Jean Chr é tien ( Prime Minister , Lib . ) moved :
que le discours de le Trône que Son Excellence a prononcé aujourd' hui devant les deux Chambres de le Parlement soit pris en considération plus tard aujourd' hui .	that the speech of His Excellency the Governor General , delivered this day from the Throne to the two Houses of Parliament , be taken into consideration later today .
( la motion est adoptée )	( motion agreed to )
* * *	* * *
le BUREAU DE RÉGIE INTERNE	board OF INTERNAL ECONOMY
le Président :	the Speaker :
je ai le honneur de informer la Chambre que les députés suivants ont été nommés membres de le Bureau de régie interne , à les fins et en vertu de les dispositions de la Loi modifiant la Loi sur le Parlement de le Canada , chapitre 42 , premier supplément , Statuts révisés de le Canada de 1985 , ce est - à - dire :	i have the honour to inform the House that the following members have been appointed as members of the Board of Internal Economy for the purposes and under the provisions of the act to amend the Parliament of Canada Act , Chapter 42 , ( First Supplement ) , the Revised Statutes of Canada , 1985 , namely :
m . Boudria etM. Gagliano , membres de le Conseil privé de la Reine ;M. Kilger et Mme Catterall , représentants de le caucus de le gouvernement ;M. Strahl etM. White ( Langley - Abbotsford ) , représentants de le caucus réformiste ; etM. Bergeron , représentant de le Bloc québécois .	Mr. Boudria and Mr. Gagliano , members of the Queen ' s Privy Council ; Mr. Kilger and Ms. Catterall , representatives of the government caucus ; Mr. Strahl and Mr. White ( Langley - Abbotsford ) , representatives of the Reform caucus ; and Mr. Bergeron , representative of the Bloc Quebecois .
* * *	* * *
le RÈGLEMENT	standing ORDERS
Lehon. Don Boudria ( Glengarry - Prescott - Russell , Lib . ) :	hon. Don Boudria ( Glengarry - Prescott - Russell , Lib . ) :
monsieur le Président , conformément à le avis , je propose que le Règlement soit modifié comme suit :	Mr. Speaker , pursuant to notice , I move that the Standing Orders be amended as follows :
au paragraphe 104 ( 1 ) , par substitution , à le mot « quatorze » , de le mot « seize » ;	in section ( 1 ) of Standing Order 104 , by deleting the word " fourteen " and by substituting therefor the word " sixteen '' ;
2 . par substitution , à le paragraphe 104 ( 2 ) , de ce qui suit :	2 . By deleting section ( 2 ) of Standing Order 104 and by substituting the following therefor :
( 2 ) Les comités permanents qui , sous réserve de le paragraphe ( 1 ) de le présent article , comprennent le nombre de députés précisé ci - dessous et pour lesquels on dressera une liste de membres , sont les suivants :	( 2 ) The standing committees , which shall consist of the number of Members stipulated below , and for which the lists of members are to be prepared , except as provided in section ( 1 ) of this Standing Order , shall be on :
a ) le Comité de les affaires autochtones et de le développement de le Grand Nord ( seize membres ) ;	( a ) Aboriginal Affairs and Northern Development ( sixteen Members ) ;
b ) le Comité de le agriculture et de le agroalimentaire ( seize membres ) ;	( b ) Agriculture and Agri - Food ( sixteen Members ) ;
c ) le Comité de le patrimoine canadien ( seize membres ) ;	( c ) Canadian Heritage ( sixteen Members ) ;
d ) le Comité de la citoyenneté et de le immigration ( seize membres ) ;	( d ) Citizenship and Immigration ( sixteen Members ) ;
e ) le Comité de le environnement et de le dévelop - pement durable ( seize membres ) ;	( e ) Environment and Sustainable Development ( sixteen Members ) ;
f ) le Comité de les finances ( seize membres ) ;	( f ) Finance ( sixteen Members ) ;
g ) le Comité de les pêches et de les océans ( seize membres ) ;	( g ) Fisheries and Oceans ( sixteen Members ) ;
h ) le Comité de les affaires étrangères et de le commerce international ( seize membres ) ;	( h ) Foreign Affairs and International Trade ( sixteen Members ) ;
i ) le Comité de la santé ( seize membres ) ;	( i ) Health ( sixteen Members ) ;
j ) le Comité de le développement de les ressources humaines et de la condition de les personnes handicapées ( seize membres ) ;	( j ) Human Resources Development and the Status of Persons with Disabilities ( sixteen Members ) ;
k ) le Comité de le industrie ( seize membres ) ;	( k ) Industry ( sixteen Members ) ;
l ) le Comité de la justice et de les droits de la personne ( seize membres ) ;	( l ) Justice and Human Rights ( sixteen Members ) ;
m ) le Comité de la défense nationale et de les anciens combattants ( seize membres ) ;	( m ) National Defence and Veterans Affairs ( sixteen Members ) ;
